src;num_pages;page_id;page_width;page_height;id;col;row;width;height;x1;y1;x2;y2;x3;y3;x4;y4;contents;contents_masked;correctclass;tag;description
ldlc192.tiff;1;1;2480;3508;57992;1757;4;172;43;1757;4;1929;4;1929;47;1757;47;Référence;AAAAAAAAA;undefined;OTHER;OTHER
ldlc192.tiff;1;1;2480;3508;57993;1941;4;20;43;1941;4;1961;4;1961;47;1941;47;à;A;undefined;OTHER;OTHER
ldlc192.tiff;1;1;2480;3508;57994;1972;4;137;43;1972;4;2109;4;2109;47;1972;47;rappeler;AAAAAAAA;undefined;OTHER;OTHER
ldlc192.tiff;1;1;2480;3508;57995;2120;4;60;43;2120;4;2180;4;2180;47;2120;47;lors;AAAA;undefined;OTHER;OTHER
ldlc192.tiff;1;1;2480;3508;57996;2191;4;41;43;2191;4;2232;4;2232;47;2191;47;du;AA;undefined;OTHER;OTHER
ldlc192.tiff;1;1;2480;3508;57997;2243;4;166;43;2243;4;2409;4;2409;47;2243;47;réglement;AAAAAAAAA;undefined;OTHER;OTHER
ldlc192.tiff;1;1;2480;3508;57998;1757;46;95;43;1757;46;1852;46;1852;89;1757;89;Client;AAAAAA;undefined;OTHER;OTHER
ldlc192.tiff;1;1;2480;3508;57999;1863;46;37;43;1863;46;1900;46;1900;89;1863;89;ID;AA;undefined;OTHER;OTHER
ldlc192.tiff;1;1;2480;3508;58004;2153;46;154;44;2153;46;2307;46;2307;90;2153;90;CL55342;AANNNNN;CNUM;CLIENT_NUMBER;Client Number
ldlc192.tiff;1;1;2480;3508;58000;1757;89;118;43;1757;89;1875;89;1875;132;1757;132;Invoice;AAAAAAA;undefined;OTHER;OTHER
ldlc192.tiff;1;1;2480;3508;58001;1886;89;37;43;1886;89;1923;89;1923;132;1886;132;ID;AA;undefined;OTHER;OTHER
ldlc192.tiff;1;1;2480;3508;58005;2153;90;175;44;2153;90;2328;90;2328;134;2153;134;FC500356;AANNNNNN;IN;INVOICE_NUMBER;Invoice Number
ldlc192.tiff;1;1;2480;3508;58002;1757;132;118;43;1757;132;1875;132;1875;175;1757;175;Invoice;AAAAAAA;undefined;OTHER;OTHER
ldlc192.tiff;1;1;2480;3508;58003;1886;132;79;43;1886;132;1965;132;1965;175;1886;175;Date;AAAA;undefined;OTHER;OTHER
ldlc192.tiff;1;1;2480;3508;58006;2153;135;75;44;2153;135;2228;135;2228;179;2153;179;may;AAA;IDATE;INVOICE_DATE;Invoice Date
ldlc192.tiff;1;1;2480;3508;58007;2239;135;52;44;2239;135;2291;135;2291;179;2239;179;17,;NNS;IDATE;INVOICE_DATE;Invoice Date
ldlc192.tiff;1;1;2480;3508;58008;2301;135;83;44;2301;135;2384;135;2384;179;2301;179;2014;NNNN;IDATE;INVOICE_DATE;Invoice Date
ldlc192.tiff;1;1;2480;3508;58009;1615;246;118;43;1615;246;1733;246;1733;289;1615;289;Invoice;AAAAAAA;undefined;OTHER;OTHER
ldlc192.tiff;1;1;2480;3508;58010;1744;246;37;43;1744;246;1781;246;1781;289;1744;289;ID;AA;undefined;OTHER;OTHER
ldlc192.tiff;1;1;2480;3508;58029;1946;246;175;44;1946;246;2121;246;2121;290;1946;290;FC500356;AANNNNNN;IN;INVOICE_NUMBER;Invoice Number
ldlc192.tiff;1;1;2480;3508;58011;1615;310;118;43;1615;310;1733;310;1733;353;1615;353;Invoice;AAAAAAA;undefined;OTHER;OTHER
ldlc192.tiff;1;1;2480;3508;58012;1744;310;79;43;1744;310;1823;310;1823;353;1744;353;Date;AAAA;undefined;OTHER;OTHER
ldlc192.tiff;1;1;2480;3508;58030;1946;311;75;44;1946;311;2021;311;2021;355;1946;355;may;AAA;IDATE;INVOICE_DATE;Invoice Date
ldlc192.tiff;1;1;2480;3508;58031;2032;311;52;44;2032;311;2084;311;2084;355;2032;355;17,;NNS;IDATE;INVOICE_DATE;Invoice Date
ldlc192.tiff;1;1;2480;3508;58032;2094;311;83;44;2094;311;2177;311;2177;355;2094;355;2014;NNNN;IDATE;INVOICE_DATE;Invoice Date
ldlc192.tiff;1;1;2480;3508;57923;83;354;30;28;83;354;113;354;113;382;83;382;LA;AA;SA;SUPPLIER_ADDRESS;Seller Address
ldlc192.tiff;1;1;2480;3508;57924;120;354;91;28;120;354;211;354;211;382;120;382;COMBE;AAAAA;SA;SUPPLIER_ADDRESS;Seller Address
ldlc192.tiff;1;1;2480;3508;57925;219;354;18;28;219;354;237;354;237;382;219;382;D;A;SA;SUPPLIER_ADDRESS;Seller Address
ldlc192.tiff;1;1;2480;3508;57926;244;354;129;28;244;354;373;354;373;382;244;382;ANDRIEUX;AAAAAAAA;SA;SUPPLIER_ADDRESS;Seller Address
ldlc192.tiff;1;1;2480;3508;57927;380;354;6;28;380;354;386;354;386;382;380;382;,;S;undefined;OTHER;OTHER
ldlc192.tiff;1;1;2480;3508;57928;394;354;69;28;394;354;463;354;463;382;394;382;38710;NNNNN;SA;SUPPLIER_ADDRESS;Seller Address
ldlc192.tiff;1;1;2480;3508;57929;470;354;8;28;470;354;478;354;478;382;470;382;-;S;SA;SUPPLIER_ADDRESS;Seller Address
ldlc192.tiff;1;1;2480;3508;57930;486;354;145;28;486;354;631;354;631;382;486;382;CORNILLON;AAAAAAAAA;SA;SUPPLIER_ADDRESS;Seller Address
ldlc192.tiff;1;1;2480;3508;57931;639;354;34;28;639;354;673;354;673;382;639;382;EN;AA;SA;SUPPLIER_ADDRESS;Seller Address
ldlc192.tiff;1;1;2480;3508;57932;680;354;106;28;680;354;786;354;786;382;680;382;TRIEVES;AAAAAAA;SA;SUPPLIER_ADDRESS;Seller Address
ldlc192.tiff;1;1;2480;3508;58013;1615;374;95;43;1615;374;1710;374;1710;417;1615;417;Client;AAAAAA;undefined;OTHER;OTHER
ldlc192.tiff;1;1;2480;3508;58014;1721;374;37;43;1721;374;1758;374;1758;417;1721;417;ID;AA;undefined;OTHER;OTHER
ldlc192.tiff;1;1;2480;3508;58033;1946;377;152;43;1946;377;2098;377;2098;420;1946;420;CL55342;AANNNNN;CNUM;CLIENT_NUMBER;Client Number
ldlc192.tiff;1;1;2480;3508;57933;83;421;88;28;83;421;171;421;171;449;83;449;Numéro;AAAAAA;undefined;OTHER;OTHER
ldlc192.tiff;1;1;2480;3508;57934;179;421;41;28;179;421;220;421;220;449;179;449;non;AAA;undefined;OTHER;OTHER
ldlc192.tiff;1;1;2480;3508;57935;227;421;81;28;227;421;308;421;308;449;227;449;surtaxé;AAAAAAA;undefined;OTHER;OTHER
ldlc192.tiff;1;1;2480;3508;57936;316;421;27;28;316;421;343;421;343;449;316;449;du;AA;undefined;OTHER;OTHER
ldlc192.tiff;1;1;2480;3508;57937;351;421;83;28;351;421;434;421;434;449;351;449;Service;AAAAAAA;undefined;OTHER;OTHER
ldlc192.tiff;1;1;2480;3508;57938;441;421;63;28;441;421;504;421;504;449;441;449;Client;AAAAAA;undefined;OTHER;OTHER
ldlc192.tiff;1;1;2480;3508;57939;512;421;6;28;512;421;518;421;518;449;512;449;:;S;undefined;OTHER;OTHER
ldlc192.tiff;1;1;2480;3508;57940;526;421;166;28;526;421;692;421;692;449;526;449;05.79.44.98.89;NNSNNSNNSNNSNN;SCN;SUPPLIER_CONTACT_NUMBER;Seller Contact Number
ldlc192.tiff;1;1;2480;3508;58015;1615;438;95;43;1615;438;1710;438;1710;481;1615;481;Order;AAAAA;undefined;OTHER;OTHER
ldlc192.tiff;1;1;2480;3508;58016;1721;438;37;43;1721;438;1758;438;1758;481;1721;481;ID;AA;undefined;OTHER;OTHER
ldlc192.tiff;1;1;2480;3508;58034;1946;441;141;44;1946;441;2087;441;2087;485;1946;485;CM5502;AANNNN;ONUM;ORDER_NUMBER;Order Number
ldlc192.tiff;1;1;2480;3508;57941;83;449;59;28;83;449;142;449;142;477;83;477;Votre;AAAAA;undefined;OTHER;OTHER
ldlc192.tiff;1;1;2480;3508;57942;150;449;84;28;150;449;234;449;234;477;150;477;numéro;AAAAAA;undefined;OTHER;OTHER
ldlc192.tiff;1;1;2480;3508;57943;241;449;27;28;241;449;268;449;268;477;241;477;de;AA;undefined;OTHER;OTHER
ldlc192.tiff;1;1;2480;3508;57944;276;449;123;28;276;449;399;449;399;477;276;477;commande;AAAAAAAA;undefined;OTHER;OTHER
ldlc192.tiff;1;1;2480;3508;57945;407;449;52;28;407;449;459;449;459;477;407;477;vous;AAAA;undefined;OTHER;OTHER
ldlc192.tiff;1;1;2480;3508;57946;466;449;48;28;466;449;514;449;514;477;466;477;sera;AAAA;undefined;OTHER;OTHER
ldlc192.tiff;1;1;2480;3508;57947;522;449;104;28;522;449;626;449;626;477;522;477;demandé;AAAAAAA;undefined;OTHER;OTHER
ldlc192.tiff;1;1;2480;3508;57948;633;449;50;28;633;449;683;449;683;477;633;477;pour;AAAA;undefined;OTHER;OTHER
ldlc192.tiff;1;1;2480;3508;57949;690;449;41;28;690;449;731;449;731;477;690;477;tout;AAAA;undefined;OTHER;OTHER
ldlc192.tiff;1;1;2480;3508;57950;739;449;61;28;739;449;800;449;800;477;739;477;appel;AAAAA;undefined;OTHER;OTHER
ldlc192.tiff;1;1;2480;3508;58017;1615;503;58;43;1615;503;1673;503;1673;546;1615;546;Ref;AAA;undefined;OTHER;OTHER
ldlc192.tiff;1;1;2480;3508;58018;1683;503;95;43;1683;503;1778;503;1778;546;1683;546;Client;AAAAAA;undefined;OTHER;OTHER
ldlc192.tiff;1;1;2480;3508;58019;1790;503;10;43;1790;503;1800;503;1800;546;1790;546;:;S;undefined;OTHER;OTHER
ldlc192.tiff;1;1;2480;3508;57951;83;516;113;28;83;516;196;516;196;544;83;544;Retrouvez;AAAAAAAAA;undefined;OTHER;OTHER
ldlc192.tiff;1;1;2480;3508;57952;204;516;117;28;204;516;321;516;321;544;204;544;l'ensemblz;ASAAAAAAAA;undefined;OTHER;OTHER
ldlc192.tiff;1;1;2480;3508;57953;328;516;27;28;328;516;355;516;355;544;328;544;de;AA;undefined;OTHER;OTHER
ldlc192.tiff;1;1;2480;3508;57954;363;516;40;28;363;516;403;516;403;544;363;544;nos;AAA;undefined;OTHER;OTHER
ldlc192.tiff;1;1;2480;3508;57955;410;516;144;28;410;516;554;516;554;544;410;544;coordonnées;AAAAAAAAAAA;undefined;OTHER;OTHER
ldlc192.tiff;1;1;2480;3508;57956;561;516;34;28;561;516;595;516;595;544;561;544;sur;AAA;undefined;OTHER;OTHER
ldlc192.tiff;1;1;2480;3508;57957;603;516;56;28;603;516;659;516;659;544;603;544;notre;AAAAA;undefined;OTHER;OTHER
ldlc192.tiff;1;1;2480;3508;57958;667;516;38;28;667;516;705;516;705;544;667;544;site;AAAA;undefined;OTHER;OTHER
ldlc192.tiff;1;1;2480;3508;57959;713;516;6;28;713;516;719;516;719;544;713;544;,;S;undefined;OTHER;OTHER
ldlc192.tiff;1;1;2480;3508;57960;727;516;91;28;727;516;818;516;818;544;727;544;rubrique;AAAAAAAA;undefined;OTHER;OTHER
ldlc192.tiff;1;1;2480;3508;57961;825;516;85;28;825;516;910;516;910;544;825;544;"""Besoin";SAAAAAA;undefined;OTHER;OTHER
ldlc192.tiff;1;1;2480;3508;57962;918;516;74;28;918;516;992;516;992;544;918;544;"d'aide""";ASAAAAS;undefined;OTHER;OTHER
ldlc192.tiff;1;1;2480;3508;58020;1615;567;225;43;1615;567;1840;567;1840;610;1615;610;Representant;AAAAAAAAAAAA;undefined;OTHER;OTHER
ldlc192.tiff;1;1;2480;3508;58021;1850;567;10;43;1850;567;1860;567;1860;610;1850;610;:;S;undefined;OTHER;OTHER
ldlc192.tiff;1;1;2480;3508;58035;1946;571;187;43;1946;571;2133;571;2133;614;1946;614;INTERNET;AAAAAAAA;undefined;OTHER;OTHER
ldlc192.tiff;1;1;2480;3508;58022;1615;631;42;43;1615;631;1657;631;1657;674;1615;674;N°;AS;undefined;OTHER;OTHER
ldlc192.tiff;1;1;2480;3508;58023;1667;631;75;43;1667;631;1742;631;1742;674;1667;674;Intra;AAAAA;undefined;OTHER;OTHER
ldlc192.tiff;1;1;2480;3508;58024;1753;631;110;43;1753;631;1863;631;1863;674;1753;674;Comm;AAAA;undefined;OTHER;OTHER
ldlc192.tiff;1;1;2480;3508;58025;1873;631;10;43;1873;631;1883;631;1883;674;1873;674;:;S;undefined;OTHER;OTHER
ldlc192.tiff;1;1;2480;3508;58026;1615;695;42;43;1615;695;1657;695;1657;738;1615;738;N°;AS;undefined;OTHER;OTHER
ldlc192.tiff;1;1;2480;3508;58027;1667;695;77;43;1667;695;1744;695;1744;738;1667;738;Siret;AAAAA;undefined;OTHER;OTHER
ldlc192.tiff;1;1;2480;3508;58028;1755;695;10;43;1755;695;1765;695;1765;738;1755;738;:;S;undefined;OTHER;OTHER
ldlc192.tiff;1;1;2480;3508;57963;927;731;625;312;927;731;1552;731;1552;1043;927;1043;;;img;IMAGE;Image
ldlc192.tiff;1;1;2480;3508;57964;116;781;104;44;116;781;220;781;220;825;116;825;Client;AAAAAA;undefined;OTHER;OTHER
ldlc192.tiff;1;1;2480;3508;57965;231;781;77;44;231;781;308;781;308;825;231;825;livré;AAAAA;undefined;OTHER;OTHER
ldlc192.tiff;1;1;2480;3508;57966;318;781;12;44;318;781;330;781;330;825;318;825;:;S;undefined;OTHER;OTHER
ldlc192.tiff;1;1;2480;3508;57978;1560;781;104;44;1560;781;1664;781;1664;825;1560;825;Client;AAAAAA;undefined;OTHER;OTHER
ldlc192.tiff;1;1;2480;3508;57979;1675;781;135;44;1675;781;1810;781;1810;825;1675;825;Facturé;AAAAAAA;undefined;OTHER;OTHER
ldlc192.tiff;1;1;2480;3508;57980;1821;781;12;44;1821;781;1833;781;1833;825;1821;825;:;S;undefined;OTHER;OTHER
ldlc192.tiff;1;1;2480;3508;57967;116;826;145;43;116;826;261;826;261;869;116;869;SIGURD;AAAAAA;BN;BILLING_NAME;Billing Name
ldlc192.tiff;1;1;2480;3508;57968;272;826;254;43;272;826;526;826;526;869;272;869;SATTERFIELD;AAAAAAAAAAA;BN;BILLING_NAME;Billing Name
ldlc192.tiff;1;1;2480;3508;57981;1560;826;145;43;1560;826;1705;826;1705;869;1560;869;SIGURD;AAAAAA;SHN;SHIPPING_NAME;Shipping Name
ldlc192.tiff;1;1;2480;3508;57982;1717;826;254;43;1717;826;1971;826;1971;869;1717;869;SATTERFIELD;AAAAAAAAAAA;SHN;SHIPPING_NAME;Shipping Name
ldlc192.tiff;1;1;2480;3508;57969;116;869;31;43;116;869;147;869;147;912;116;912;8,;NS;BA;BILLING_ADDRESS;Billing Address
ldlc192.tiff;1;1;2480;3508;57970;158;869;79;43;158;869;237;869;237;912;158;912;RUE;AAA;BA;BILLING_ADDRESS;Billing Address
ldlc192.tiff;1;1;2480;3508;57971;247;869;52;43;247;869;299;869;299;912;247;912;DE;AA;BA;BILLING_ADDRESS;Billing Address
ldlc192.tiff;1;1;2480;3508;57972;310;869;153;43;310;869;463;869;463;912;310;912;L'HÔTEL;ASAAAAA;BA;BILLING_ADDRESS;Billing Address
ldlc192.tiff;1;1;2480;3508;57973;473;869;52;43;473;869;525;869;525;912;473;912;DE;AA;BA;BILLING_ADDRESS;Billing Address
ldlc192.tiff;1;1;2480;3508;57974;536;869;102;43;536;869;638;869;638;912;536;912;VILLE;AAAAA;BA;BILLING_ADDRESS;Billing Address
ldlc192.tiff;1;1;2480;3508;57983;1560;869;31;43;1560;869;1591;869;1591;912;1560;912;8,;NS;SHA;SHIPPING_ADDRESS;Shipping Address
ldlc192.tiff;1;1;2480;3508;57984;1602;869;79;43;1602;869;1681;869;1681;912;1602;912;RUE;AAA;SHA;SHIPPING_ADDRESS;Shipping Address
ldlc192.tiff;1;1;2480;3508;57985;1692;869;52;43;1692;869;1744;869;1744;912;1692;912;DE;AA;SHA;SHIPPING_ADDRESS;Shipping Address
ldlc192.tiff;1;1;2480;3508;57986;1754;869;153;43;1754;869;1907;869;1907;912;1754;912;L'HÔTEL;ASAAAAA;SHA;SHIPPING_ADDRESS;Shipping Address
ldlc192.tiff;1;1;2480;3508;57987;1918;869;52;43;1918;869;1970;869;1970;912;1918;912;DE;AA;SHA;SHIPPING_ADDRESS;Shipping Address
ldlc192.tiff;1;1;2480;3508;57988;1980;869;102;43;1980;869;2082;869;2082;912;1980;912;VILLE;AAAAA;SHA;SHIPPING_ADDRESS;Shipping Address
ldlc192.tiff;1;1;2480;3508;57975;116;913;104;43;116;913;220;913;220;956;116;956;59620;NNNNN;BA;BILLING_ADDRESS;Billing Address
ldlc192.tiff;1;1;2480;3508;57976;231;913;385;43;231;913;616;913;616;956;231;956;AULNOYE-AYMERIES;AAAAAAASAAAAAAAA;BA;BILLING_ADDRESS;Billing Address
ldlc192.tiff;1;1;2480;3508;57989;1560;913;104;43;1560;913;1664;913;1664;956;1560;956;59620;NNNNN;SHA;SHIPPING_ADDRESS;Shipping Address
ldlc192.tiff;1;1;2480;3508;57990;1675;913;385;43;1675;913;2060;913;2060;956;1675;956;AULNOYE-AYMERIES;AAAAAAASAAAAAAAA;SHA;SHIPPING_ADDRESS;Shipping Address
ldlc192.tiff;1;1;2480;3508;57977;116;956;154;43;116;956;270;956;270;999;116;999;FRANCE;AAAAAA;BA;BILLING_ADDRESS;Billing Address
ldlc192.tiff;1;1;2480;3508;57991;1560;956;154;43;1560;956;1714;956;1714;999;1560;999;FRANCE;AAAAAA;SHA;SHIPPING_ADDRESS;Shipping Address
ldlc192.tiff;1;1;2480;3508;58036;1173;1044;175;43;1173;1044;1348;1044;1348;1087;1173;1087;FC500356;AANNNNNN;IN;INVOICE_NUMBER;Invoice Number
ldlc192.tiff;1;1;2480;3508;58056;2188;1135;87;44;2188;1135;2275;1135;2275;1179;2188;1179;page;AAAA;undefined;OTHER;OTHER
ldlc192.tiff;1;1;2480;3508;58057;2286;1135;52;44;2286;1135;2338;1135;2338;1179;2286;1179;1/1;NSN;undefined;OTHER;OTHER
ldlc192.tiff;1;1;2480;3508;58037;104;1140;152;34;104;1140;256;1140;256;1174;104;1174;GARANTIE;AAAAAAAA;undefined;OTHER;OTHER
ldlc192.tiff;1;1;2480;3508;58038;264;1140;9;34;264;1140;273;1140;273;1174;264;1174;:;S;undefined;OTHER;OTHER
ldlc192.tiff;1;1;2480;3508;58039;282;1140;50;34;282;1140;332;1140;332;1174;282;1174;Les;AAA;undefined;OTHER;OTHER
ldlc192.tiff;1;1;2480;3508;58040;340;1140;137;34;340;1140;477;1140;477;1174;340;1174;étiquettes;AAAAAAAAAA;undefined;OTHER;OTHER
ldlc192.tiff;1;1;2480;3508;58041;486;1140;98;34;486;1140;584;1140;584;1174;486;1174;collées;AAAAAAA;undefined;OTHER;OTHER
ldlc192.tiff;1;1;2480;3508;58042;593;1140;45;34;593;1140;638;1140;638;1174;593;1174;sur;AAA;undefined;OTHER;OTHER
ldlc192.tiff;1;1;2480;3508;58043;647;1140;40;34;647;1140;687;1140;687;1174;647;1174;les;AAA;undefined;OTHER;OTHER
ldlc192.tiff;1;1;2480;3508;58044;695;1140;90;34;695;1140;785;1140;785;1174;695;1174;pièces;AAAAAA;undefined;OTHER;OTHER
ldlc192.tiff;1;1;2480;3508;58045;794;1140;100;34;794;1140;894;1140;894;1174;794;1174;neuves;AAAAAA;undefined;OTHER;OTHER
ldlc192.tiff;1;1;2480;3508;58046;903;1140;61;34;903;1140;964;1140;964;1174;903;1174;sont;AAAA;undefined;OTHER;OTHER
ldlc192.tiff;1;1;2480;3508;58047;972;1140;150;34;972;1140;1122;1140;1122;1174;972;1174;nécessaire;AAAAAAAAAA;undefined;OTHER;OTHER
ldlc192.tiff;1;1;2480;3508;58048;1131;1140;64;34;1131;1140;1195;1140;1195;1174;1131;1174;pour;AAAA;undefined;OTHER;OTHER
ldlc192.tiff;1;1;2480;3508;58049;1204;1140;24;34;1204;1140;1228;1140;1228;1174;1204;1174;la;AA;undefined;OTHER;OTHER
ldlc192.tiff;1;1;2480;3508;58050;1237;1140;121;34;1237;1140;1358;1140;1358;1174;1237;1174;garantie.;AAAAAAAAS;undefined;OTHER;OTHER
ldlc192.tiff;1;1;2480;3508;58051;1366;1140;50;34;1366;1140;1416;1140;1416;1174;1366;1174;Les;AAA;undefined;OTHER;OTHER
ldlc192.tiff;1;1;2480;3508;58052;1425;1140;158;34;1425;1140;1583;1140;1583;1174;1425;1174;emballages;AAAAAAAAAA;undefined;OTHER;OTHER
ldlc192.tiff;1;1;2480;3508;58053;1592;1140;103;34;1592;1140;1695;1140;1695;1174;1592;1174;doivent;AAAAAAA;undefined;OTHER;OTHER
ldlc192.tiff;1;1;2480;3508;58054;1704;1140;53;34;1704;1140;1757;1140;1757;1174;1704;1174;être;AAAA;undefined;OTHER;OTHER
ldlc192.tiff;1;1;2480;3508;58055;1765;1140;144;34;1765;1140;1909;1140;1909;1174;1765;1174;conservés;AAAAAAAAA;undefined;OTHER;OTHER
ldlc192.tiff;1;1;2480;3508;58058;112;1225;83;39;112;1225;195;1225;195;1264;112;1264;Code;AAAA;undefined;OTHER;OTHER
ldlc192.tiff;1;1;2480;3508;58059;404;1225;190;39;404;1225;594;1225;594;1264;404;1264;Designation;AAAAAAAAAAA;undefined;OTHER;OTHER
ldlc192.tiff;1;1;2480;3508;58060;1279;1225;55;39;1279;1225;1334;1225;1334;1264;1279;1264;Qté;AAA;undefined;OTHER;OTHER
ldlc192.tiff;1;1;2480;3508;58061;1395;1225;40;39;1395;1225;1435;1225;1435;1264;1395;1264;Px;AA;undefined;OTHER;OTHER
ldlc192.tiff;1;1;2480;3508;58062;1445;1225;74;39;1445;1225;1519;1225;1519;1264;1445;1264;Unit.;AAAAS;undefined;OTHER;OTHER
ldlc192.tiff;1;1;2480;3508;58063;1583;1225;72;39;1583;1225;1655;1225;1655;1264;1583;1264;Rem;AAA;undefined;OTHER;OTHER
ldlc192.tiff;1;1;2480;3508;58064;1664;1225;29;39;1664;1225;1693;1225;1693;1264;1664;1264;%;S;undefined;OTHER;OTHER
ldlc192.tiff;1;1;2480;3508;58065;1729;1225;49;39;1729;1225;1778;1225;1778;1264;1729;1264;Mtt;AAA;undefined;OTHER;OTHER
ldlc192.tiff;1;1;2480;3508;58066;1788;1225;85;39;1788;1225;1873;1225;1873;1264;1788;1264;base.;AAAAS;undefined;OTHER;OTHER
ldlc192.tiff;1;1;2480;3508;58067;1937;1225;103;39;1937;1225;2040;1225;2040;1264;1937;1264;Eco-P.;AAASAS;undefined;OTHER;OTHER
ldlc192.tiff;1;1;2480;3508;58068;2050;1225;44;39;2050;1225;2094;1225;2094;1264;2050;1264;HT;AA;undefined;OTHER;OTHER
ldlc192.tiff;1;1;2480;3508;58069;2104;1225;62;39;2104;1225;2166;1225;2166;1264;2104;1264;Uni.;AAAS;undefined;OTHER;OTHER
ldlc192.tiff;1;1;2480;3508;58070;2176;1225;51;39;2176;1225;2227;1225;2227;1264;2176;1264;Vte;AAA;undefined;OTHER;OTHER
ldlc192.tiff;1;1;2480;3508;58071;2270;1225;20;39;2270;1225;2290;1225;2290;1264;2270;1264;T;A;undefined;OTHER;OTHER
ldlc192.tiff;1;1;2480;3508;58072;112;1306;240;38;112;1306;352;1306;352;1344;112;1344;5012512117331;NNNNNNNNNNNNN;SNO;SNO;SNO
ldlc192.tiff;1;1;2480;3508;58073;404;1306;212;38;404;1306;616;1306;616;1344;404;1344;ASPIRATEUR;AAAAAAAAAA;PD;PRODUCT_DESCRIPTION;Product Description
ldlc192.tiff;1;1;2480;3508;58074;626;1306;68;38;626;1306;694;1306;694;1344;626;1344;EAU;AAA;PD;PRODUCT_DESCRIPTION;Product Description
ldlc192.tiff;1;1;2480;3508;58075;704;1306;42;38;704;1306;746;1306;746;1344;704;1344;ET;AA;PD;PRODUCT_DESCRIPTION;Product Description
ldlc192.tiff;1;1;2480;3508;58076;756;1306;194;38;756;1306;950;1306;950;1344;756;1344;POUSSIÈRE;AAAAAAAAA;PD;PRODUCT_DESCRIPTION;Product Description
ldlc192.tiff;1;1;2480;3508;58077;959;1306;66;38;959;1306;1025;1306;1025;1344;959;1344;VAX;AAA;PD;PRODUCT_DESCRIPTION;Product Description
ldlc192.tiff;1;1;2480;3508;58078;1035;1306;187;38;1035;1306;1222;1306;1222;1344;1035;1344;INJECTEUR;AAAAAAAAA;PD;PRODUCT_DESCRIPTION;Product Description
ldlc192.tiff;1;1;2480;3508;58081;1279;1306;46;38;1279;1306;1325;1306;1325;1344;1279;1344;2.0;NSN;QTY;QUANTITY;Quantity
ldlc192.tiff;1;1;2480;3508;58082;1395;1306;120;38;1395;1306;1515;1306;1515;1344;1395;1344;140.833;NNNSNNN;UP;UNIT_PRICE;Unit Price Without Tax
ldlc192.tiff;1;1;2480;3508;58083;1583;1306;46;38;1583;1306;1629;1306;1629;1344;1583;1344;0.0;NSN;undefined;OTHER;OTHER
ldlc192.tiff;1;1;2480;3508;58084;1729;1306;120;38;1729;1306;1849;1306;1849;1344;1729;1344;281.666;NNNSNNN;PTWTX;PRODUCT_TOTAL_PRICE_WITHOUT_TAX;Product Total Price without TAX
ldlc192.tiff;1;1;2480;3508;58085;1937;1306;46;38;1937;1306;1983;1306;1983;1344;1937;1344;0.0;NSN;undefined;OTHER;OTHER
ldlc192.tiff;1;1;2480;3508;58086;2104;1306;53;38;2104;1306;2157;1306;2157;1344;2104;1344;PIE;AAA;undefined;OTHER;OTHER
ldlc192.tiff;1;1;2480;3508;58087;2262;1306;18;38;2262;1306;2280;1306;2280;1344;2262;1344;4;N;undefined;OTHER;OTHER
ldlc192.tiff;1;1;2480;3508;58079;404;1344;225;38;404;1344;629;1344;629;1382;404;1382;EXTRACTEUR;AAAAAAAAAA;PD;PRODUCT_DESCRIPTION;Product Description
ldlc192.tiff;1;1;2480;3508;58080;639;1344;74;38;639;1344;713;1344;713;1382;639;1382;6131;NNNN;PD;PRODUCT_DESCRIPTION;Product Description
ldlc192.tiff;1;1;2480;3508;58088;112;1425;240;38;112;1425;352;1425;352;1463;112;1463;3452858626944;NNNNNNNNNNNNN;SNO;SNO;SNO
ldlc192.tiff;1;1;2480;3508;58089;404;1425;105;38;404;1425;509;1425;509;1463;404;1463;RADIO;AAAAA;PD;PRODUCT_DESCRIPTION;Product Description
ldlc192.tiff;1;1;2480;3508;58090;519;1425;118;38;519;1425;637;1425;637;1463;519;1463;RÉVEIL;AAAAAA;PD;PRODUCT_DESCRIPTION;Product Description
ldlc192.tiff;1;1;2480;3508;58091;646;1425;133;38;646;1425;779;1425;779;1463;646;1463;NAFNAF;AAAAAA;PD;PRODUCT_DESCRIPTION;Product Description
ldlc192.tiff;1;1;2480;3508;58092;789;1425;188;38;789;1425;977;1425;977;1463;789;1463;CLOCKLINE;AAAAAAAAA;PD;PRODUCT_DESCRIPTION;Product Description
ldlc192.tiff;1;1;2480;3508;58093;987;1425;83;38;987;1425;1070;1425;1070;1463;987;1463;NOIR;AAAA;PD;PRODUCT_DESCRIPTION;Product Description
ldlc192.tiff;1;1;2480;3508;58094;1279;1425;46;38;1279;1425;1325;1425;1325;1463;1279;1463;1.0;NSN;QTY;QUANTITY;Quantity
ldlc192.tiff;1;1;2480;3508;58095;1395;1425;101;38;1395;1425;1496;1425;1496;1463;1395;1463;28.333;NNSNNN;UP;UNIT_PRICE;Unit Price Without Tax
ldlc192.tiff;1;1;2480;3508;58096;1583;1425;46;38;1583;1425;1629;1425;1629;1463;1583;1463;0.0;NSN;undefined;OTHER;OTHER
ldlc192.tiff;1;1;2480;3508;58097;1729;1425;101;38;1729;1425;1830;1425;1830;1463;1729;1463;28.333;NNSNNN;PTWTX;PRODUCT_TOTAL_PRICE_WITHOUT_TAX;Product Total Price without TAX
ldlc192.tiff;1;1;2480;3508;58098;1937;1425;46;38;1937;1425;1983;1425;1983;1463;1937;1463;0.0;NSN;undefined;OTHER;OTHER
ldlc192.tiff;1;1;2480;3508;58099;2104;1425;53;38;2104;1425;2157;1425;2157;1463;2104;1463;PIE;AAA;undefined;OTHER;OTHER
ldlc192.tiff;1;1;2480;3508;58100;2262;1425;18;38;2262;1425;2280;1425;2280;1463;2262;1463;4;N;undefined;OTHER;OTHER
ldlc192.tiff;1;1;2480;3508;58112;1425;2475;145;44;1425;2475;1570;2475;1570;2519;1425;2519;Montant;AAAAAAA;undefined;OTHER;OTHER
ldlc192.tiff;1;1;2480;3508;58113;1581;2475;120;44;1581;2475;1701;2475;1701;2519;1581;2519;remise;AAAAAA;undefined;OTHER;OTHER
ldlc192.tiff;1;1;2480;3508;58126;2208;2475;72;43;2208;2475;2280;2475;2280;2518;2208;2518;0,00;NSNN;undefined;OTHER;OTHER
ldlc192.tiff;1;1;2480;3508;58101;112;2487;20;39;112;2487;132;2487;132;2526;112;2526;T;A;undefined;OTHER;OTHER
ldlc192.tiff;1;1;2480;3508;58102;295;2487;29;39;295;2487;324;2487;324;2526;295;2526;%;S;undefined;OTHER;OTHER
ldlc192.tiff;1;1;2480;3508;58103;334;2487;66;39;334;2487;400;2487;400;2526;334;2526;TVA;AAA;undefined;OTHER;OTHER
ldlc192.tiff;1;1;2480;3508;58104;537;2487;92;39;537;2487;629;2487;629;2526;537;2526;BASE;AAAA;undefined;OTHER;OTHER
ldlc192.tiff;1;1;2480;3508;58105;639;2487;46;39;639;2487;685;2487;685;2526;639;2526;DE;AA;undefined;OTHER;OTHER
ldlc192.tiff;1;1;2480;3508;58106;694;2487;137;39;694;2487;831;2487;831;2526;694;2526;CALCUL;AAAAAA;undefined;OTHER;OTHER
ldlc192.tiff;1;1;2480;3508;58107;912;2487;111;39;912;2487;1023;2487;1023;2526;912;2526;TOTAL;AAAAA;undefined;OTHER;OTHER
ldlc192.tiff;1;1;2480;3508;58127;2208;2518;72;43;2208;2518;2280;2518;2280;2561;2208;2561;0,00;NSNN;undefined;OTHER;OTHER
ldlc192.tiff;1;1;2480;3508;58114;1425;2519;145;44;1425;2519;1570;2519;1570;2563;1425;2563;Montant;AAAAAAA;undefined;OTHER;OTHER
ldlc192.tiff;1;1;2480;3508;58115;1581;2519;72;44;1581;2519;1653;2519;1653;2563;1581;2563;port;AAAA;undefined;OTHER;OTHER
ldlc192.tiff;1;1;2480;3508;58128;2208;2561;93;43;2208;2561;2301;2561;2301;2604;2208;2604;309.0;NNNSN;TWTX;TOTAL_WITHOUT_TAX;TWTXS
ldlc192.tiff;1;1;2480;3508;58116;1425;2564;89;44;1425;2564;1514;2564;1514;2608;1425;2608;Total;AAAAA;undefined;OTHER;OTHER
ldlc192.tiff;1;1;2480;3508;58108;112;2568;18;38;112;2568;130;2568;130;2606;112;2606;4;N;undefined;OTHER;OTHER
ldlc192.tiff;1;1;2480;3508;58109;295;2568;37;38;295;2568;332;2568;332;2606;295;2606;20;NN;TXR;TAX_RATE;Tax Rate
ldlc192.tiff;1;1;2480;3508;58110;537;2568;120;38;537;2568;657;2568;657;2606;537;2606;309.999;NNNSNNN;TTX;TOTAL_TAX;Total Tax
ldlc192.tiff;1;1;2480;3508;58111;912;2568;101;38;912;2568;1013;2568;1013;2606;912;2606;61.999;NNSNNN;undefined;OTHER;OTHER
ldlc192.tiff;1;1;2480;3508;58129;2208;2605;72;43;2208;2605;2280;2605;2280;2648;2208;2648;0,00;NSNN;undefined;OTHER;OTHER
ldlc192.tiff;1;1;2480;3508;58117;1425;2608;85;44;1425;2608;1510;2608;1510;2652;1425;2652;Dont;AAAA;undefined;OTHER;OTHER
ldlc192.tiff;1;1;2480;3508;58118;1520;2608;302;44;1520;2608;1822;2608;1822;2652;1520;2652;eco-participation;AAASAAAAAAAAAAAAA;undefined;OTHER;OTHER
ldlc192.tiff;1;1;2480;3508;58130;2208;2648;72;43;2208;2648;2280;2648;2280;2691;2208;2691;62.0;NNSN;TTX;TOTAL_TAX;Total Tax
ldlc192.tiff;1;1;2480;3508;58119;1425;2653;75;44;1425;2653;1500;2653;1500;2697;1425;2697;TVA;AAA;undefined;OTHER;OTHER
ldlc192.tiff;1;1;2480;3508;58120;1510;2653;81;44;1510;2653;1591;2653;1591;2697;1510;2697;Rate;AAAA;undefined;OTHER;OTHER
ldlc192.tiff;1;1;2480;3508;58131;2208;2691;93;43;2208;2691;2301;2691;2301;2734;2208;2734;372.0;NNNSN;TA;TOTAL_AMOUNT;Total with TAX
ldlc192.tiff;1;1;2480;3508;58121;1425;2698;141;44;1425;2698;1566;2698;1566;2742;1425;2742;Amount;AAAAAA;undefined;OTHER;OTHER
ldlc192.tiff;1;1;2480;3508;58122;1577;2698;35;44;1577;2698;1612;2698;1612;2742;1577;2742;to;AA;undefined;OTHER;OTHER
ldlc192.tiff;1;1;2480;3508;58123;1622;2698;64;44;1622;2698;1686;2698;1686;2742;1622;2742;pay;AAA;undefined;OTHER;OTHER
ldlc192.tiff;1;1;2480;3508;58132;2208;2735;93;43;2208;2735;2301;2735;2301;2778;2208;2778;372.0;NNNSN;TA;TOTAL_AMOUNT;Total with TAX
ldlc192.tiff;1;1;2480;3508;58124;1425;2742;95;44;1425;2742;1520;2742;1520;2786;1425;2786;Votre;AAAAA;undefined;OTHER;OTHER
ldlc192.tiff;1;1;2480;3508;58125;1531;2742;179;44;1531;2742;1710;2742;1710;2786;1531;2786;reglèment;AAAAAAAAA;undefined;OTHER;OTHER
ldlc192.tiff;1;1;2480;3508;58144;124;2750;70;44;124;2750;194;2750;194;2794;124;2794;Nos;AAA;undefined;OTHER;OTHER
ldlc192.tiff;1;1;2480;3508;58145;206;2750;145;44;206;2750;351;2750;351;2794;206;2794;factures;AAAAAAAA;undefined;OTHER;OTHER
ldlc192.tiff;1;1;2480;3508;58146;362;2750;79;44;362;2750;441;2750;441;2794;362;2794;sont;AAAA;undefined;OTHER;OTHER
ldlc192.tiff;1;1;2480;3508;58147;452;2750;148;44;452;2750;600;2750;600;2794;452;2794;libellées;AAAAAAAAA;undefined;OTHER;OTHER
ldlc192.tiff;1;1;2480;3508;58148;610;2750;43;44;610;2750;653;2750;653;2794;610;2794;en;AA;undefined;OTHER;OTHER
ldlc192.tiff;1;1;2480;3508;58149;664;2750;116;44;664;2750;780;2750;780;2794;664;2794;Euros.;AAAAAS;undefined;OTHER;OTHER
ldlc192.tiff;1;1;2480;3508;58150;124;2833;116;44;124;2833;240;2833;240;2877;124;2877;Aucun;AAAAA;undefined;OTHER;OTHER
ldlc192.tiff;1;1;2480;3508;58151;252;2833;175;44;252;2833;427;2833;427;2877;252;2877;escompte;AAAAAAAA;undefined;OTHER;OTHER
ldlc192.tiff;1;1;2480;3508;58152;437;2833;83;44;437;2833;520;2833;520;2877;437;2877;pour;AAAA;undefined;OTHER;OTHER
ldlc192.tiff;1;1;2480;3508;58153;531;2833;143;44;531;2833;674;2833;674;2877;531;2877;paiment;AAAAAAA;undefined;OTHER;OTHER
ldlc192.tiff;1;1;2480;3508;58154;685;2833;141;44;685;2833;826;2833;826;2877;685;2877;anticipé;AAAAAAAA;undefined;OTHER;OTHER
ldlc192.tiff;1;1;2480;3508;58155;837;2833;43;44;837;2833;880;2833;880;2877;837;2877;ne;AA;undefined;OTHER;OTHER
ldlc192.tiff;1;1;2480;3508;58156;891;2833;77;44;891;2833;968;2833;968;2877;891;2877;sera;AAAA;undefined;OTHER;OTHER
ldlc192.tiff;1;1;2480;3508;58157;979;2833;133;44;979;2833;1112;2833;1112;2877;979;2877;ccordé.;AAAAAAS;undefined;OTHER;OTHER
ldlc192.tiff;1;1;2480;3508;58133;1429;2841;75;44;1429;2841;1504;2841;1504;2885;1429;2885;NET;AAA;undefined;OTHER;OTHER
ldlc192.tiff;1;1;2480;3508;58134;1514;2841;27;44;1514;2841;1541;2841;1541;2885;1514;2885;A;A;undefined;OTHER;OTHER
ldlc192.tiff;1;1;2480;3508;58135;1552;2841;129;44;1552;2841;1681;2841;1681;2885;1552;2885;PAYER;AAAAA;undefined;OTHER;OTHER
ldlc192.tiff;1;1;2480;3508;58140;2125;2841;72;44;2125;2841;2197;2841;2197;2885;2125;2885;0,00;NSNN;undefined;OTHER;OTHER
ldlc192.tiff;1;1;2480;3508;58136;1429;2886;81;44;1429;2886;1510;2886;1510;2930;1429;2930;Date;AAAA;undefined;OTHER;OTHER
ldlc192.tiff;1;1;2480;3508;58137;1520;2886;97;44;1520;2886;1617;2886;1617;2930;1520;2930;limite;AAAAAA;undefined;OTHER;OTHER
ldlc192.tiff;1;1;2480;3508;58138;1629;2886;43;44;1629;2886;1672;2886;1672;2930;1629;2930;de;AA;undefined;OTHER;OTHER
ldlc192.tiff;1;1;2480;3508;58139;1683;2886;164;44;1683;2886;1847;2886;1847;2930;1683;2930;paiement;AAAAAAAA;undefined;OTHER;OTHER
ldlc192.tiff;1;1;2480;3508;58141;2125;2886;70;43;2125;2886;2195;2886;2195;2929;2125;2929;may;AAA;IDATE;INVOICE_DATE;Invoice Date
ldlc192.tiff;1;1;2480;3508;58142;2206;2886;52;43;2206;2886;2258;2886;2258;2929;2206;2929;17,;NNS;IDATE;INVOICE_DATE;Invoice Date
ldlc192.tiff;1;1;2480;3508;58143;2268;2886;83;43;2268;2886;2351;2886;2351;2929;2268;2929;2014;NNNN;IDATE;INVOICE_DATE;Invoice Date
ldlc192.tiff;1;1;2480;3508;58158;116;2945;210;43;116;2945;326;2945;326;2988;116;2988;CONDITION;AAAAAAAAA;undefined;OTHER;OTHER
ldlc192.tiff;1;1;2480;3508;58159;337;2945;52;43;337;2945;389;2945;389;2988;337;2988;DE;AA;undefined;OTHER;OTHER
ldlc192.tiff;1;1;2480;3508;58160;400;2945;233;43;400;2945;633;2945;633;2988;400;2988;REGLEMENT;AAAAAAAAA;undefined;OTHER;OTHER
ldlc192.tiff;1;1;2480;3508;58163;800;2945;40;28;800;2945;840;2945;840;2973;800;2973;Les;AAA;undefined;OTHER;OTHER
ldlc192.tiff;1;1;2480;3508;58164;847;2945;112;28;847;2945;959;2945;959;2973;847;2973;conditions;AAAAAAAAAA;undefined;OTHER;OTHER
ldlc192.tiff;1;1;2480;3508;58165;966;2945;109;28;966;2945;1075;2945;1075;2973;966;2973;générales;AAAAAAAAA;undefined;OTHER;OTHER
ldlc192.tiff;1;1;2480;3508;58166;1083;2945;27;28;1083;2945;1110;2945;1110;2973;1083;2973;de;AA;undefined;OTHER;OTHER
ldlc192.tiff;1;1;2480;3508;58167;1118;2945;73;28;1118;2945;1191;2945;1191;2973;1118;2973;ventes;AAAAAA;undefined;OTHER;OTHER
ldlc192.tiff;1;1;2480;3508;58168;1198;2945;88;28;1198;2945;1286;2945;1286;2973;1198;2973;"(""CGV"")";SSAAASS;undefined;OTHER;OTHER
ldlc192.tiff;1;1;2480;3508;58169;1294;2945;125;28;1294;2945;1419;2945;1419;2973;1294;2973;appilcables;AAAAAAAAAAA;undefined;OTHER;OTHER
ldlc192.tiff;1;1;2480;3508;58170;1426;2945;13;28;1426;2945;1439;2945;1439;2973;1426;2973;a;A;undefined;OTHER;OTHER
ldlc192.tiff;1;1;2480;3508;58171;1447;2945;55;28;1447;2945;1502;2945;1502;2973;1447;2973;votre;AAAAA;undefined;OTHER;OTHER
ldlc192.tiff;1;1;2480;3508;58172;1509;2945;123;28;1509;2945;1632;2945;1632;2973;1509;2973;commande;AAAAAAAA;undefined;OTHER;OTHER
ldlc192.tiff;1;1;2480;3508;58173;1640;2945;113;28;1640;2945;1753;2945;1753;2973;1640;2973;acceptées;AAAAAAAAA;undefined;OTHER;OTHER
ldlc192.tiff;1;1;2480;3508;58174;1761;2945;40;28;1761;2945;1801;2945;1801;2973;1761;2973;lors;AAAA;undefined;OTHER;OTHER
ldlc192.tiff;1;1;2480;3508;58175;1808;2945;27;28;1808;2945;1835;2945;1835;2973;1808;2973;de;AA;undefined;OTHER;OTHER
ldlc192.tiff;1;1;2480;3508;58176;1843;2945;40;28;1843;2945;1883;2945;1883;2973;1843;2973;son;AAA;undefined;OTHER;OTHER
ldlc192.tiff;1;1;2480;3508;58177;1890;2945;166;28;1890;2945;2056;2945;2056;2973;1890;2973;enregistrement;AAAAAAAAAAAAAA;undefined;OTHER;OTHER
ldlc192.tiff;1;1;2480;3508;58178;2064;2945;47;28;2064;2945;2111;2945;2111;2973;2064;2973;sont;AAAA;undefined;OTHER;OTHER
ldlc192.tiff;1;1;2480;3508;58179;800;2974;116;28;800;2974;916;2974;916;3002;800;3002;également;AAAAAAAAA;undefined;OTHER;OTHER
ldlc192.tiff;1;1;2480;3508;58180;923;2974;125;28;923;2974;1048;2974;1048;3002;923;3002;disponibles;AAAAAAAAAAA;undefined;OTHER;OTHER
ldlc192.tiff;1;1;2480;3508;58181;1055;2974;34;28;1055;2974;1089;2974;1089;3002;1055;3002;sur;AAA;undefined;OTHER;OTHER
ldlc192.tiff;1;1;2480;3508;58182;1097;2974;56;28;1097;2974;1153;2974;1153;3002;1097;3002;notre;AAAAA;undefined;OTHER;OTHER
ldlc192.tiff;1;1;2480;3508;58183;1161;2974;45;28;1161;2974;1206;2974;1206;3002;1161;3002;site.;AAAAS;undefined;OTHER;OTHER
ldlc192.tiff;1;1;2480;3508;58161;116;2989;108;44;116;2989;224;2989;224;3033;116;3033;Credit;AAAAAA;undefined;OTHER;OTHER
ldlc192.tiff;1;1;2480;3508;58162;235;2989;79;44;235;2989;314;2989;314;3033;235;3033;card;AAAA;undefined;OTHER;OTHER
ldlc192.tiff;1;1;2480;3508;58184;800;3041;30;28;800;3041;830;3041;830;3069;800;3069;LA;AA;SN;SUPPLIER_NAME;Seller/Company) name
ldlc192.tiff;1;1;2480;3508;58185;837;3041;87;28;837;3041;924;3041;924;3069;837;3069;FERME;AAAAA;SN;SUPPLIER_NAME;Seller/Company) name
ldlc192.tiff;1;1;2480;3508;58186;931;3041;36;28;931;3041;967;3041;967;3069;931;3069;DU;AA;SN;SUPPLIER_NAME;Seller/Company) name
ldlc192.tiff;1;1;2480;3508;58187;975;3041;66;28;975;3041;1041;3041;1041;3069;975;3069;CLOT;AAAA;SN;SUPPLIER_NAME;Seller/Company) name
ldlc192.tiff;1;1;2480;3508;58188;1048;3041;0;28;1048;3041;1048;3041;1048;3069;1048;3069;;;undefined;OTHER;OTHER
ldlc192.tiff;1;1;2480;3508;58189;1055;3041;8;28;1055;3041;1063;3041;1063;3069;1055;3069;-;S;undefined;OTHER;OTHER
ldlc192.tiff;1;1;2480;3508;58190;1070;3041;33;28;1070;3041;1103;3041;1103;3069;1070;3069;SA;AA;undefined;OTHER;OTHER
ldlc192.tiff;1;1;2480;3508;58191;1111;3041;13;28;1111;3041;1124;3041;1124;3069;1111;3069;à;A;undefined;OTHER;OTHER
ldlc192.tiff;1;1;2480;3508;58192;1132;3041;102;28;1132;3041;1234;3041;1234;3069;1132;3069;directoire;AAAAAAAAAA;undefined;OTHER;OTHER
ldlc192.tiff;1;1;2480;3508;58193;1241;3041;20;28;1241;3041;1261;3041;1261;3069;1241;3069;et;AA;undefined;OTHER;OTHER
ldlc192.tiff;1;1;2480;3508;58194;1269;3041;77;28;1269;3041;1346;3041;1346;3069;1269;3069;conseil;AAAAAAA;undefined;OTHER;OTHER
ldlc192.tiff;1;1;2480;3508;58195;1354;3041;27;28;1354;3041;1381;3041;1381;3069;1354;3069;de;AA;undefined;OTHER;OTHER
ldlc192.tiff;1;1;2480;3508;58196;1389;3041;131;28;1389;3041;1520;3041;1520;3069;1389;3069;surveillance;AAAAAAAAAAAA;undefined;OTHER;OTHER
ldlc192.tiff;1;1;2480;3508;58197;1527;3041;27;28;1527;3041;1554;3041;1554;3069;1527;3069;au;AA;undefined;OTHER;OTHER
ldlc192.tiff;1;1;2480;3508;58198;1562;3041;72;28;1562;3041;1634;3041;1634;3069;1562;3069;capital;AAAAAAA;undefined;OTHER;OTHER
ldlc192.tiff;1;1;2480;3508;58199;1641;3041;27;28;1641;3041;1668;3041;1668;3069;1641;3069;de;AA;undefined;OTHER;OTHER
ldlc192.tiff;1;1;2480;3508;58200;1676;3041;97;28;1676;3041;1773;3041;1773;3069;1676;3069;4020514;NNNNNNN;undefined;OTHER;OTHER
ldlc192.tiff;1;1;2480;3508;58201;1780;3041;38;28;1780;3041;1818;3041;1818;3069;1780;3069;Eur;AAA;undefined;OTHER;OTHER
ldlc192.tiff;1;1;2480;3508;58202;1826;3041;8;28;1826;3041;1834;3041;1834;3069;1826;3069;-;S;undefined;OTHER;OTHER
ldlc192.tiff;1;1;2480;3508;58203;1842;3041;125;28;1842;3041;1967;3041;1967;3069;1842;3069;136180790;NNNNNNNNN;SCID;SUPPLIER_ID;Seller Identifier Number (Siren)
ldlc192.tiff;1;1;2480;3508;58204;800;3070;50;28;800;3070;850;3070;850;3098;800;3098;APE;AAA;undefined;OTHER;OTHER
ldlc192.tiff;1;1;2480;3508;58205;856;3070;0;28;856;3070;856;3070;856;3098;856;3098;;;undefined;OTHER;OTHER
ldlc192.tiff;1;1;2480;3508;58206;863;3070;8;28;863;3070;871;3070;871;3098;863;3098;-;S;undefined;OTHER;OTHER
ldlc192.tiff;1;1;2480;3508;58207;879;3070;48;28;879;3070;927;3070;927;3098;879;3098;VAT;AAA;undefined;OTHER;OTHER
ldlc192.tiff;1;1;2480;3508;58208;934;3070;88;28;934;3070;1022;3070;1022;3098;934;3098;Number;AAAAAA;undefined;OTHER;OTHER
ldlc192.tiff;1;1;2480;3508;58209;1030;3070;186;28;1030;3070;1216;3070;1216;3098;1030;3098;FR13136180790;AANNNNNNNNNNN;SVAT;SUPPLIER_VAT;Seller Vat Number/TVA
ldlc192.tiff;1;1;2480;3508;58210;800;3098;51;28;800;3098;851;3098;851;3126;800;3126;Siret;AAAAA;undefined;OTHER;OTHER
ldlc192.tiff;1;1;2480;3508;58211;858;3098;6;28;858;3098;864;3098;864;3126;858;3126;:;S;undefined;OTHER;OTHER
ldlc192.tiff;1;1;2480;3508;58212;872;3098;194;28;872;3098;1066;3098;1066;3126;872;3126;13618079070801;NNNNNNNNNNNNNN;undefined;OTHER;OTHER
ldlc192.tiff;1;1;2480;3508;58213;991;3274;31;28;991;3274;1022;3274;1022;3302;991;3302;Ne;AA;undefined;OTHER;OTHER
ldlc192.tiff;1;1;2480;3508;58214;1030;3274;40;28;1030;3274;1070;3274;1070;3302;1030;3302;pas;AAA;undefined;OTHER;OTHER
ldlc192.tiff;1;1;2480;3508;58215;1077;3274;48;28;1077;3274;1125;3274;1125;3302;1077;3302;jeter;AAAAA;undefined;OTHER;OTHER
ldlc192.tiff;1;1;2480;3508;58216;1133;3274;34;28;1133;3274;1167;3274;1167;3302;1133;3302;sur;AAA;undefined;OTHER;OTHER
ldlc192.tiff;1;1;2480;3508;58217;1175;3274;19;28;1175;3274;1194;3274;1194;3302;1175;3302;la;AA;undefined;OTHER;OTHER
ldlc192.tiff;1;1;2480;3508;58218;1201;3274;45;28;1201;3274;1246;3274;1246;3302;1201;3302;voie;AAAA;undefined;OTHER;OTHER
ldlc192.tiff;1;1;2480;3508;58219;1254;3274;94;28;1254;3274;1348;3274;1348;3302;1254;3302;publique;AAAAAAAA;undefined;OTHER;OTHER
