src;num_pages;page_id;page_width;page_height;id;col;row;width;height;x1;y1;x2;y2;x3;y3;x4;y4;contents;contents_masked;correctclass;tag;description
ldlc144.tiff;1;1;2480;3508;43352;1757;4;172;43;1757;4;1929;4;1929;47;1757;47;Référence;AAAAAAAAA;undefined;OTHER;OTHER
ldlc144.tiff;1;1;2480;3508;43353;1941;4;20;43;1941;4;1961;4;1961;47;1941;47;à;A;undefined;OTHER;OTHER
ldlc144.tiff;1;1;2480;3508;43354;1972;4;137;43;1972;4;2109;4;2109;47;1972;47;rappeler;AAAAAAAA;undefined;OTHER;OTHER
ldlc144.tiff;1;1;2480;3508;43355;2120;4;60;43;2120;4;2180;4;2180;47;2120;47;lors;AAAA;undefined;OTHER;OTHER
ldlc144.tiff;1;1;2480;3508;43356;2191;4;41;43;2191;4;2232;4;2232;47;2191;47;du;AA;undefined;OTHER;OTHER
ldlc144.tiff;1;1;2480;3508;43357;2243;4;166;43;2243;4;2409;4;2409;47;2243;47;réglement;AAAAAAAAA;undefined;OTHER;OTHER
ldlc144.tiff;1;1;2480;3508;43358;1757;46;95;43;1757;46;1852;46;1852;89;1757;89;Client;AAAAAA;undefined;OTHER;OTHER
ldlc144.tiff;1;1;2480;3508;43359;1863;46;58;43;1863;46;1921;46;1921;89;1863;89;No.;AAS;undefined;OTHER;OTHER
ldlc144.tiff;1;1;2480;3508;43363;2153;46;104;44;2153;46;2257;46;2257;90;2153;90;76961;NNNNN;CNUM;CLIENT_NUMBER;Client Number
ldlc144.tiff;1;1;2480;3508;43360;1757;89;118;43;1757;89;1875;89;1875;132;1757;132;Invoice;AAAAAAA;undefined;OTHER;OTHER
ldlc144.tiff;1;1;2480;3508;43361;1886;89;58;43;1886;89;1944;89;1944;132;1886;132;No.;AAS;undefined;OTHER;OTHER
ldlc144.tiff;1;1;2480;3508;43364;2153;90;145;44;2153;90;2298;90;2298;134;2153;134;1135887;NNNNNNN;IN;INVOICE_NUMBER;Invoice Number
ldlc144.tiff;1;1;2480;3508;43362;1757;132;100;43;1757;132;1857;132;1857;175;1757;175;Dated;AAAAA;undefined;OTHER;OTHER
ldlc144.tiff;1;1;2480;3508;43365;2153;135;56;44;2153;135;2209;135;2209;179;2153;179;jun;AAA;IDATE;INVOICE_DATE;Invoice Date
ldlc144.tiff;1;1;2480;3508;43366;2220;135;52;44;2220;135;2272;135;2272;179;2220;179;25,;NNS;IDATE;INVOICE_DATE;Invoice Date
ldlc144.tiff;1;1;2480;3508;43367;2282;135;83;44;2282;135;2365;135;2365;179;2282;179;1990;NNNN;IDATE;INVOICE_DATE;Invoice Date
ldlc144.tiff;1;1;2480;3508;43368;1615;246;118;43;1615;246;1733;246;1733;289;1615;289;Invoice;AAAAAAA;undefined;OTHER;OTHER
ldlc144.tiff;1;1;2480;3508;43369;1744;246;58;43;1744;246;1802;246;1802;289;1744;289;No.;AAS;undefined;OTHER;OTHER
ldlc144.tiff;1;1;2480;3508;43387;1946;246;145;44;1946;246;2091;246;2091;290;1946;290;1135887;NNNNNNN;IN;INVOICE_NUMBER;Invoice Number
ldlc144.tiff;1;1;2480;3508;43370;1615;310;100;43;1615;310;1715;310;1715;353;1615;353;Dated;AAAAA;undefined;OTHER;OTHER
ldlc144.tiff;1;1;2480;3508;43388;1946;311;56;44;1946;311;2002;311;2002;355;1946;355;jun;AAA;IDATE;INVOICE_DATE;Invoice Date
ldlc144.tiff;1;1;2480;3508;43389;2013;311;52;44;2013;311;2065;311;2065;355;2013;355;25,;NNS;IDATE;INVOICE_DATE;Invoice Date
ldlc144.tiff;1;1;2480;3508;43390;2076;311;83;44;2076;311;2159;311;2159;355;2076;355;1990;NNNN;IDATE;INVOICE_DATE;Invoice Date
ldlc144.tiff;1;1;2480;3508;43287;83;354;27;28;83;354;110;354;110;382;83;382;12;NN;SA;SUPPLIER_ADDRESS;Seller Address
ldlc144.tiff;1;1;2480;3508;43288;118;354;52;28;118;354;170;354;170;382;118;382;RUE;AAA;SA;SUPPLIER_ADDRESS;Seller Address
ldlc144.tiff;1;1;2480;3508;43289;177;354;34;28;177;354;211;354;211;382;177;382;DE;AA;SA;SUPPLIER_ADDRESS;Seller Address
ldlc144.tiff;1;1;2480;3508;43290;219;354;30;28;219;354;249;354;249;382;219;382;LA;AA;SA;SUPPLIER_ADDRESS;Seller Address
ldlc144.tiff;1;1;2480;3508;43291;257;354;88;28;257;354;345;354;345;382;257;382;BORNE;AAAAA;SA;SUPPLIER_ADDRESS;Seller Address
ldlc144.tiff;1;1;2480;3508;43292;352;354;52;28;352;354;404;354;404;382;352;382;SUD;AAA;SA;SUPPLIER_ADDRESS;Seller Address
ldlc144.tiff;1;1;2480;3508;43293;412;354;6;28;412;354;418;354;418;382;412;382;,;S;undefined;OTHER;OTHER
ldlc144.tiff;1;1;2480;3508;43294;426;354;69;28;426;354;495;354;495;382;426;382;92190;NNNNN;SA;SUPPLIER_ADDRESS;Seller Address
ldlc144.tiff;1;1;2480;3508;43295;502;354;8;28;502;354;510;354;510;382;502;382;-;S;SA;SUPPLIER_ADDRESS;Seller Address
ldlc144.tiff;1;1;2480;3508;43296;518;354;111;28;518;354;629;354;629;382;518;382;MEUDON;AAAAAA;SA;SUPPLIER_ADDRESS;Seller Address
ldlc144.tiff;1;1;2480;3508;43371;1615;374;95;43;1615;374;1710;374;1710;417;1615;417;Client;AAAAAA;undefined;OTHER;OTHER
ldlc144.tiff;1;1;2480;3508;43372;1721;374;58;43;1721;374;1779;374;1779;417;1721;417;No.;AAS;undefined;OTHER;OTHER
ldlc144.tiff;1;1;2480;3508;43391;1946;377;104;43;1946;377;2050;377;2050;420;1946;420;76961;NNNNN;CNUM;CLIENT_NUMBER;Client Number
ldlc144.tiff;1;1;2480;3508;43297;83;421;88;28;83;421;171;421;171;449;83;449;Numéro;AAAAAA;undefined;OTHER;OTHER
ldlc144.tiff;1;1;2480;3508;43298;179;421;41;28;179;421;220;421;220;449;179;449;non;AAA;undefined;OTHER;OTHER
ldlc144.tiff;1;1;2480;3508;43299;227;421;81;28;227;421;308;421;308;449;227;449;surtaxé;AAAAAAA;undefined;OTHER;OTHER
ldlc144.tiff;1;1;2480;3508;43300;316;421;27;28;316;421;343;421;343;449;316;449;du;AA;undefined;OTHER;OTHER
ldlc144.tiff;1;1;2480;3508;43301;351;421;83;28;351;421;434;421;434;449;351;449;Service;AAAAAAA;undefined;OTHER;OTHER
ldlc144.tiff;1;1;2480;3508;43302;441;421;63;28;441;421;504;421;504;449;441;449;Client;AAAAAA;undefined;OTHER;OTHER
ldlc144.tiff;1;1;2480;3508;43303;512;421;6;28;512;421;518;421;518;449;512;449;:;S;undefined;OTHER;OTHER
ldlc144.tiff;1;1;2480;3508;43304;526;421;172;28;526;421;698;421;698;449;526;449;07-90-98-81-89;NNSNNSNNSNNSNN;SCN;SUPPLIER_CONTACT_NUMBER;Seller Contact Number
ldlc144.tiff;1;1;2480;3508;43373;1615;438;95;43;1615;438;1710;438;1710;481;1615;481;Order;AAAAA;undefined;OTHER;OTHER
ldlc144.tiff;1;1;2480;3508;43374;1721;438;58;43;1721;438;1779;438;1779;481;1721;481;No.;AAS;undefined;OTHER;OTHER
ldlc144.tiff;1;1;2480;3508;43392;1946;441;83;44;1946;441;2029;441;2029;485;1946;485;2744;NNNN;ONUM;ORDER_NUMBER;Order Number
ldlc144.tiff;1;1;2480;3508;43305;83;449;59;28;83;449;142;449;142;477;83;477;Votre;AAAAA;undefined;OTHER;OTHER
ldlc144.tiff;1;1;2480;3508;43306;150;449;84;28;150;449;234;449;234;477;150;477;numéro;AAAAAA;undefined;OTHER;OTHER
ldlc144.tiff;1;1;2480;3508;43307;241;449;27;28;241;449;268;449;268;477;241;477;de;AA;undefined;OTHER;OTHER
ldlc144.tiff;1;1;2480;3508;43308;276;449;123;28;276;449;399;449;399;477;276;477;commande;AAAAAAAA;undefined;OTHER;OTHER
ldlc144.tiff;1;1;2480;3508;43309;407;449;52;28;407;449;459;449;459;477;407;477;vous;AAAA;undefined;OTHER;OTHER
ldlc144.tiff;1;1;2480;3508;43310;466;449;48;28;466;449;514;449;514;477;466;477;sera;AAAA;undefined;OTHER;OTHER
ldlc144.tiff;1;1;2480;3508;43311;522;449;104;28;522;449;626;449;626;477;522;477;demandé;AAAAAAA;undefined;OTHER;OTHER
ldlc144.tiff;1;1;2480;3508;43312;633;449;50;28;633;449;683;449;683;477;633;477;pour;AAAA;undefined;OTHER;OTHER
ldlc144.tiff;1;1;2480;3508;43313;690;449;41;28;690;449;731;449;731;477;690;477;tout;AAAA;undefined;OTHER;OTHER
ldlc144.tiff;1;1;2480;3508;43314;739;449;61;28;739;449;800;449;800;477;739;477;appel;AAAAA;undefined;OTHER;OTHER
ldlc144.tiff;1;1;2480;3508;43375;1615;503;58;43;1615;503;1673;503;1673;546;1615;546;Ref;AAA;undefined;OTHER;OTHER
ldlc144.tiff;1;1;2480;3508;43376;1683;503;95;43;1683;503;1778;503;1778;546;1683;546;Client;AAAAAA;undefined;OTHER;OTHER
ldlc144.tiff;1;1;2480;3508;43377;1790;503;10;43;1790;503;1800;503;1800;546;1790;546;:;S;undefined;OTHER;OTHER
ldlc144.tiff;1;1;2480;3508;43315;83;516;113;28;83;516;196;516;196;544;83;544;Retrouvez;AAAAAAAAA;undefined;OTHER;OTHER
ldlc144.tiff;1;1;2480;3508;43316;204;516;117;28;204;516;321;516;321;544;204;544;l'ensemblz;ASAAAAAAAA;undefined;OTHER;OTHER
ldlc144.tiff;1;1;2480;3508;43317;328;516;27;28;328;516;355;516;355;544;328;544;de;AA;undefined;OTHER;OTHER
ldlc144.tiff;1;1;2480;3508;43318;363;516;40;28;363;516;403;516;403;544;363;544;nos;AAA;undefined;OTHER;OTHER
ldlc144.tiff;1;1;2480;3508;43319;410;516;144;28;410;516;554;516;554;544;410;544;coordonnées;AAAAAAAAAAA;undefined;OTHER;OTHER
ldlc144.tiff;1;1;2480;3508;43320;561;516;34;28;561;516;595;516;595;544;561;544;sur;AAA;undefined;OTHER;OTHER
ldlc144.tiff;1;1;2480;3508;43321;603;516;56;28;603;516;659;516;659;544;603;544;notre;AAAAA;undefined;OTHER;OTHER
ldlc144.tiff;1;1;2480;3508;43322;667;516;38;28;667;516;705;516;705;544;667;544;site;AAAA;undefined;OTHER;OTHER
ldlc144.tiff;1;1;2480;3508;43323;713;516;6;28;713;516;719;516;719;544;713;544;,;S;undefined;OTHER;OTHER
ldlc144.tiff;1;1;2480;3508;43324;727;516;91;28;727;516;818;516;818;544;727;544;rubrique;AAAAAAAA;undefined;OTHER;OTHER
ldlc144.tiff;1;1;2480;3508;43325;825;516;85;28;825;516;910;516;910;544;825;544;"""Besoin";SAAAAAA;undefined;OTHER;OTHER
ldlc144.tiff;1;1;2480;3508;43326;918;516;74;28;918;516;992;516;992;544;918;544;"d'aide""";ASAAAAS;undefined;OTHER;OTHER
ldlc144.tiff;1;1;2480;3508;43378;1615;567;225;43;1615;567;1840;567;1840;610;1615;610;Representant;AAAAAAAAAAAA;undefined;OTHER;OTHER
ldlc144.tiff;1;1;2480;3508;43379;1850;567;10;43;1850;567;1860;567;1860;610;1850;610;:;S;undefined;OTHER;OTHER
ldlc144.tiff;1;1;2480;3508;43393;1946;571;187;43;1946;571;2133;571;2133;614;1946;614;INTERNET;AAAAAAAA;undefined;OTHER;OTHER
ldlc144.tiff;1;1;2480;3508;43380;1615;631;42;43;1615;631;1657;631;1657;674;1615;674;N°;AS;undefined;OTHER;OTHER
ldlc144.tiff;1;1;2480;3508;43381;1667;631;75;43;1667;631;1742;631;1742;674;1667;674;Intra;AAAAA;undefined;OTHER;OTHER
ldlc144.tiff;1;1;2480;3508;43382;1753;631;110;43;1753;631;1863;631;1863;674;1753;674;Comm;AAAA;undefined;OTHER;OTHER
ldlc144.tiff;1;1;2480;3508;43383;1873;631;10;43;1873;631;1883;631;1883;674;1873;674;:;S;undefined;OTHER;OTHER
ldlc144.tiff;1;1;2480;3508;43384;1615;695;42;43;1615;695;1657;695;1657;738;1615;738;N°;AS;undefined;OTHER;OTHER
ldlc144.tiff;1;1;2480;3508;43385;1667;695;77;43;1667;695;1744;695;1744;738;1667;738;Siret;AAAAA;undefined;OTHER;OTHER
ldlc144.tiff;1;1;2480;3508;43386;1755;695;10;43;1755;695;1765;695;1765;738;1755;738;:;S;undefined;OTHER;OTHER
ldlc144.tiff;1;1;2480;3508;43327;927;731;625;312;927;731;1552;731;1552;1043;927;1043;;;img;IMAGE;Image
ldlc144.tiff;1;1;2480;3508;43328;116;781;104;44;116;781;220;781;220;825;116;825;Client;AAAAAA;undefined;OTHER;OTHER
ldlc144.tiff;1;1;2480;3508;43329;231;781;77;44;231;781;308;781;308;825;231;825;livré;AAAAA;undefined;OTHER;OTHER
ldlc144.tiff;1;1;2480;3508;43330;318;781;12;44;318;781;330;781;330;825;318;825;:;S;undefined;OTHER;OTHER
ldlc144.tiff;1;1;2480;3508;43340;1560;781;104;44;1560;781;1664;781;1664;825;1560;825;Client;AAAAAA;undefined;OTHER;OTHER
ldlc144.tiff;1;1;2480;3508;43341;1675;781;135;44;1675;781;1810;781;1810;825;1675;825;Facturé;AAAAAAA;undefined;OTHER;OTHER
ldlc144.tiff;1;1;2480;3508;43342;1821;781;12;44;1821;781;1833;781;1833;825;1821;825;:;S;undefined;OTHER;OTHER
ldlc144.tiff;1;1;2480;3508;43331;116;826;97;43;116;826;213;826;213;869;116;869;SAUL;AAAA;BN;BILLING_NAME;Billing Name
ldlc144.tiff;1;1;2480;3508;43332;225;826;104;43;225;826;329;826;329;869;225;869;TORP;AAAA;BN;BILLING_NAME;Billing Name
ldlc144.tiff;1;1;2480;3508;43343;1560;826;97;43;1560;826;1657;826;1657;869;1560;869;SAUL;AAAA;SHN;SHIPPING_NAME;Shipping Name
ldlc144.tiff;1;1;2480;3508;43344;1669;826;104;43;1669;826;1773;826;1773;869;1669;869;TORP;AAAA;SHN;SHIPPING_NAME;Shipping Name
ldlc144.tiff;1;1;2480;3508;43333;116;869;93;43;116;869;209;869;209;912;116;912;5029,;NNNNS;BA;BILLING_ADDRESS;Billing Address
ldlc144.tiff;1;1;2480;3508;43334;220;869;131;43;220;869;351;869;351;912;220;912;ROUTE;AAAAA;BA;BILLING_ADDRESS;Billing Address
ldlc144.tiff;1;1;2480;3508;43335;362;869;52;43;362;869;414;869;414;912;362;912;DE;AA;BA;BILLING_ADDRESS;Billing Address
ldlc144.tiff;1;1;2480;3508;43336;425;869;285;43;425;869;710;869;710;912;425;912;CHEVANCEAUX;AAAAAAAAAAA;BA;BILLING_ADDRESS;Billing Address
ldlc144.tiff;1;1;2480;3508;43345;1560;869;93;43;1560;869;1653;869;1653;912;1560;912;5029,;NNNNS;SHA;SHIPPING_ADDRESS;Shipping Address
ldlc144.tiff;1;1;2480;3508;43346;1665;869;131;43;1665;869;1796;869;1796;912;1665;912;ROUTE;AAAAA;SHA;SHIPPING_ADDRESS;Shipping Address
ldlc144.tiff;1;1;2480;3508;43347;1806;869;52;43;1806;869;1858;869;1858;912;1806;912;DE;AA;SHA;SHIPPING_ADDRESS;Shipping Address
ldlc144.tiff;1;1;2480;3508;43348;1869;869;285;43;1869;869;2154;869;2154;912;1869;912;CHEVANCEAUX;AAAAAAAAAAA;SHA;SHIPPING_ADDRESS;Shipping Address
ldlc144.tiff;1;1;2480;3508;43337;116;913;104;43;116;913;220;913;220;956;116;956;17270;NNNNN;BA;BILLING_ADDRESS;Billing Address
ldlc144.tiff;1;1;2480;3508;43338;231;913;390;43;231;913;621;913;621;956;231;956;SAINT-MARTIN-D'ARY;AAAAASAAAAAASASAAA;BA;BILLING_ADDRESS;Billing Address
ldlc144.tiff;1;1;2480;3508;43349;1560;913;104;43;1560;913;1664;913;1664;956;1560;956;17270;NNNNN;SHA;SHIPPING_ADDRESS;Shipping Address
ldlc144.tiff;1;1;2480;3508;43350;1675;913;390;43;1675;913;2065;913;2065;956;1675;956;SAINT-MARTIN-D'ARY;AAAAASAAAAAASASAAA;SHA;SHIPPING_ADDRESS;Shipping Address
ldlc144.tiff;1;1;2480;3508;43339;116;956;154;43;116;956;270;956;270;999;116;999;FRANCE;AAAAAA;BA;BILLING_ADDRESS;Billing Address
ldlc144.tiff;1;1;2480;3508;43351;1560;956;154;43;1560;956;1714;956;1714;999;1560;999;FRANCE;AAAAAA;SHA;SHIPPING_ADDRESS;Shipping Address
ldlc144.tiff;1;1;2480;3508;43394;1181;1044;145;43;1181;1044;1326;1044;1326;1087;1181;1087;1135887;NNNNNNN;IN;INVOICE_NUMBER;Invoice Number
ldlc144.tiff;1;1;2480;3508;43414;2188;1135;87;44;2188;1135;2275;1135;2275;1179;2188;1179;page;AAAA;undefined;OTHER;OTHER
ldlc144.tiff;1;1;2480;3508;43415;2286;1135;52;44;2286;1135;2338;1135;2338;1179;2286;1179;1/1;NSN;undefined;OTHER;OTHER
ldlc144.tiff;1;1;2480;3508;43395;104;1140;152;34;104;1140;256;1140;256;1174;104;1174;GARANTIE;AAAAAAAA;undefined;OTHER;OTHER
ldlc144.tiff;1;1;2480;3508;43396;264;1140;9;34;264;1140;273;1140;273;1174;264;1174;:;S;undefined;OTHER;OTHER
ldlc144.tiff;1;1;2480;3508;43397;282;1140;50;34;282;1140;332;1140;332;1174;282;1174;Les;AAA;undefined;OTHER;OTHER
ldlc144.tiff;1;1;2480;3508;43398;340;1140;137;34;340;1140;477;1140;477;1174;340;1174;étiquettes;AAAAAAAAAA;undefined;OTHER;OTHER
ldlc144.tiff;1;1;2480;3508;43399;486;1140;98;34;486;1140;584;1140;584;1174;486;1174;collées;AAAAAAA;undefined;OTHER;OTHER
ldlc144.tiff;1;1;2480;3508;43400;593;1140;45;34;593;1140;638;1140;638;1174;593;1174;sur;AAA;undefined;OTHER;OTHER
ldlc144.tiff;1;1;2480;3508;43401;647;1140;40;34;647;1140;687;1140;687;1174;647;1174;les;AAA;undefined;OTHER;OTHER
ldlc144.tiff;1;1;2480;3508;43402;695;1140;90;34;695;1140;785;1140;785;1174;695;1174;pièces;AAAAAA;undefined;OTHER;OTHER
ldlc144.tiff;1;1;2480;3508;43403;794;1140;100;34;794;1140;894;1140;894;1174;794;1174;neuves;AAAAAA;undefined;OTHER;OTHER
ldlc144.tiff;1;1;2480;3508;43404;903;1140;61;34;903;1140;964;1140;964;1174;903;1174;sont;AAAA;undefined;OTHER;OTHER
ldlc144.tiff;1;1;2480;3508;43405;972;1140;150;34;972;1140;1122;1140;1122;1174;972;1174;nécessaire;AAAAAAAAAA;undefined;OTHER;OTHER
ldlc144.tiff;1;1;2480;3508;43406;1131;1140;64;34;1131;1140;1195;1140;1195;1174;1131;1174;pour;AAAA;undefined;OTHER;OTHER
ldlc144.tiff;1;1;2480;3508;43407;1204;1140;24;34;1204;1140;1228;1140;1228;1174;1204;1174;la;AA;undefined;OTHER;OTHER
ldlc144.tiff;1;1;2480;3508;43408;1237;1140;121;34;1237;1140;1358;1140;1358;1174;1237;1174;garantie.;AAAAAAAAS;undefined;OTHER;OTHER
ldlc144.tiff;1;1;2480;3508;43409;1366;1140;50;34;1366;1140;1416;1140;1416;1174;1366;1174;Les;AAA;undefined;OTHER;OTHER
ldlc144.tiff;1;1;2480;3508;43410;1425;1140;158;34;1425;1140;1583;1140;1583;1174;1425;1174;emballages;AAAAAAAAAA;undefined;OTHER;OTHER
ldlc144.tiff;1;1;2480;3508;43411;1592;1140;103;34;1592;1140;1695;1140;1695;1174;1592;1174;doivent;AAAAAAA;undefined;OTHER;OTHER
ldlc144.tiff;1;1;2480;3508;43412;1704;1140;53;34;1704;1140;1757;1140;1757;1174;1704;1174;être;AAAA;undefined;OTHER;OTHER
ldlc144.tiff;1;1;2480;3508;43413;1765;1140;144;34;1765;1140;1909;1140;1909;1174;1765;1174;conservés;AAAAAAAAA;undefined;OTHER;OTHER
ldlc144.tiff;1;1;2480;3508;43416;112;1225;83;39;112;1225;195;1225;195;1264;112;1264;Code;AAAA;undefined;OTHER;OTHER
ldlc144.tiff;1;1;2480;3508;43417;404;1225;190;39;404;1225;594;1225;594;1264;404;1264;Designation;AAAAAAAAAAA;undefined;OTHER;OTHER
ldlc144.tiff;1;1;2480;3508;43418;1279;1225;55;39;1279;1225;1334;1225;1334;1264;1279;1264;Qté;AAA;undefined;OTHER;OTHER
ldlc144.tiff;1;1;2480;3508;43419;1395;1225;40;39;1395;1225;1435;1225;1435;1264;1395;1264;Px;AA;undefined;OTHER;OTHER
ldlc144.tiff;1;1;2480;3508;43420;1445;1225;74;39;1445;1225;1519;1225;1519;1264;1445;1264;Unit.;AAAAS;undefined;OTHER;OTHER
ldlc144.tiff;1;1;2480;3508;43421;1583;1225;72;39;1583;1225;1655;1225;1655;1264;1583;1264;Rem;AAA;undefined;OTHER;OTHER
ldlc144.tiff;1;1;2480;3508;43422;1664;1225;29;39;1664;1225;1693;1225;1693;1264;1664;1264;%;S;undefined;OTHER;OTHER
ldlc144.tiff;1;1;2480;3508;43423;1729;1225;49;39;1729;1225;1778;1225;1778;1264;1729;1264;Mtt;AAA;undefined;OTHER;OTHER
ldlc144.tiff;1;1;2480;3508;43424;1788;1225;85;39;1788;1225;1873;1225;1873;1264;1788;1264;base.;AAAAS;undefined;OTHER;OTHER
ldlc144.tiff;1;1;2480;3508;43425;1937;1225;103;39;1937;1225;2040;1225;2040;1264;1937;1264;Eco-P.;AAASAS;undefined;OTHER;OTHER
ldlc144.tiff;1;1;2480;3508;43426;2050;1225;44;39;2050;1225;2094;1225;2094;1264;2050;1264;HT;AA;undefined;OTHER;OTHER
ldlc144.tiff;1;1;2480;3508;43427;2104;1225;62;39;2104;1225;2166;1225;2166;1264;2104;1264;Uni.;AAAS;undefined;OTHER;OTHER
ldlc144.tiff;1;1;2480;3508;43428;2176;1225;51;39;2176;1225;2227;1225;2227;1264;2176;1264;Vte;AAA;undefined;OTHER;OTHER
ldlc144.tiff;1;1;2480;3508;43429;2270;1225;20;39;2270;1225;2290;1225;2290;1264;2270;1264;T;A;undefined;OTHER;OTHER
ldlc144.tiff;1;1;2480;3508;43430;112;1306;240;38;112;1306;352;1306;352;1344;112;1344;4957812592147;NNNNNNNNNNNNN;SNO;SNO;SNO
ldlc144.tiff;1;1;2480;3508;43431;404;1306;168;38;404;1306;572;1306;572;1344;404;1344;ENCEINTE;AAAAAAAA;PD;PRODUCT_DESCRIPTION;Product Description
ldlc144.tiff;1;1;2480;3508;43432;581;1306;246;38;581;1306;827;1306;827;1344;581;1344;BIBLIOTHÈQUE;AAAAAAAAAAAA;PD;PRODUCT_DESCRIPTION;Product Description
ldlc144.tiff;1;1;2480;3508;43433;837;1306;140;38;837;1306;977;1306;977;1344;837;1344;YAMAHA;AAAAAA;PD;PRODUCT_DESCRIPTION;Product Description
ldlc144.tiff;1;1;2480;3508;43434;987;1306;196;38;987;1306;1183;1306;1183;1344;987;1344;MUSICCAST;AAAAAAAAA;PD;PRODUCT_DESCRIPTION;Product Description
ldlc144.tiff;1;1;2480;3508;43438;1279;1306;46;38;1279;1306;1325;1306;1325;1344;1279;1344;1.0;NSN;QTY;QUANTITY;Quantity
ldlc144.tiff;1;1;2480;3508;43439;1395;1306;83;38;1395;1306;1478;1306;1478;1344;1395;1344;532.5;NNNSN;UP;UNIT_PRICE;Unit Price Without Tax
ldlc144.tiff;1;1;2480;3508;43440;1583;1306;46;38;1583;1306;1629;1306;1629;1344;1583;1344;0.0;NSN;undefined;OTHER;OTHER
ldlc144.tiff;1;1;2480;3508;43441;1729;1306;83;38;1729;1306;1812;1306;1812;1344;1729;1344;532.5;NNNSN;PTWTX;PRODUCT_TOTAL_PRICE_WITHOUT_TAX;Product Total Price without TAX
ldlc144.tiff;1;1;2480;3508;43442;1937;1306;46;38;1937;1306;1983;1306;1983;1344;1937;1344;0.0;NSN;undefined;OTHER;OTHER
ldlc144.tiff;1;1;2480;3508;43443;2104;1306;53;38;2104;1306;2157;1306;2157;1344;2104;1344;PIE;AAA;undefined;OTHER;OTHER
ldlc144.tiff;1;1;2480;3508;43444;2262;1306;18;38;2262;1306;2280;1306;2280;1344;2262;1344;4;N;undefined;OTHER;OTHER
ldlc144.tiff;1;1;2480;3508;43435;404;1344;125;38;404;1344;529;1344;529;1382;404;1382;NXN500;AAANNN;PD;PRODUCT_DESCRIPTION;Product Description
ldlc144.tiff;1;1;2480;3508;43436;539;1344;83;38;539;1344;622;1344;622;1382;539;1382;NOIR;AAAA;PD;PRODUCT_DESCRIPTION;Product Description
ldlc144.tiff;1;1;2480;3508;43437;631;1344;40;38;631;1344;671;1344;671;1382;631;1382;X2;AN;PD;PRODUCT_DESCRIPTION;Product Description
ldlc144.tiff;1;1;2480;3508;43445;112;1425;240;38;112;1425;352;1425;352;1463;112;1463;0790776000945;NNNNNNNNNNNNN;SNO;SNO;SNO
ldlc144.tiff;1;1;2480;3508;43446;404;1425;177;38;404;1425;581;1425;581;1463;404;1463;CENTRALE;AAAAAAAA;PD;PRODUCT_DESCRIPTION;Product Description
ldlc144.tiff;1;1;2480;3508;43447;591;1425;137;38;591;1425;728;1425;728;1463;591;1463;VAPEUR;AAAAAA;PD;PRODUCT_DESCRIPTION;Product Description
ldlc144.tiff;1;1;2480;3508;43448;737;1425;200;38;737;1425;937;1425;937;1463;737;1463;LAURASTAR;AAAAAAAAA;PD;PRODUCT_DESCRIPTION;Product Description
ldlc144.tiff;1;1;2480;3508;43449;946;1425;68;38;946;1425;1014;1425;1014;1463;946;1463;LIFT;AAAA;PD;PRODUCT_DESCRIPTION;Product Description
ldlc144.tiff;1;1;2480;3508;43450;1024;1425;70;38;1024;1425;1094;1425;1094;1463;1024;1463;RED;AAA;PD;PRODUCT_DESCRIPTION;Product Description
ldlc144.tiff;1;1;2480;3508;43451;1279;1425;46;38;1279;1425;1325;1425;1325;1463;1279;1463;3.0;NSN;QTY;QUANTITY;Quantity
ldlc144.tiff;1;1;2480;3508;43452;1395;1425;83;38;1395;1425;1478;1425;1478;1463;1395;1463;332.5;NNNSN;UP;UNIT_PRICE;Unit Price Without Tax
ldlc144.tiff;1;1;2480;3508;43453;1583;1425;46;38;1583;1425;1629;1425;1629;1463;1583;1463;0.0;NSN;undefined;OTHER;OTHER
ldlc144.tiff;1;1;2480;3508;43454;1729;1425;83;38;1729;1425;1812;1425;1812;1463;1729;1463;997.5;NNNSN;PTWTX;PRODUCT_TOTAL_PRICE_WITHOUT_TAX;Product Total Price without TAX
ldlc144.tiff;1;1;2480;3508;43455;1937;1425;46;38;1937;1425;1983;1425;1983;1463;1937;1463;0.0;NSN;undefined;OTHER;OTHER
ldlc144.tiff;1;1;2480;3508;43456;2104;1425;53;38;2104;1425;2157;1425;2157;1463;2104;1463;PIE;AAA;undefined;OTHER;OTHER
ldlc144.tiff;1;1;2480;3508;43457;2262;1425;18;38;2262;1425;2280;1425;2280;1463;2262;1463;4;N;undefined;OTHER;OTHER
ldlc144.tiff;1;1;2480;3508;43469;1425;2475;145;44;1425;2475;1570;2475;1570;2519;1425;2519;Montant;AAAAAAA;undefined;OTHER;OTHER
ldlc144.tiff;1;1;2480;3508;43470;1581;2475;120;44;1581;2475;1701;2475;1701;2519;1581;2519;remise;AAAAAA;undefined;OTHER;OTHER
ldlc144.tiff;1;1;2480;3508;43481;2208;2475;72;43;2208;2475;2280;2475;2280;2518;2208;2518;0,00;NSNN;undefined;OTHER;OTHER
ldlc144.tiff;1;1;2480;3508;43458;112;2487;20;39;112;2487;132;2487;132;2526;112;2526;T;A;undefined;OTHER;OTHER
ldlc144.tiff;1;1;2480;3508;43459;295;2487;29;39;295;2487;324;2487;324;2526;295;2526;%;S;undefined;OTHER;OTHER
ldlc144.tiff;1;1;2480;3508;43460;334;2487;66;39;334;2487;400;2487;400;2526;334;2526;TVA;AAA;undefined;OTHER;OTHER
ldlc144.tiff;1;1;2480;3508;43461;537;2487;92;39;537;2487;629;2487;629;2526;537;2526;BASE;AAAA;undefined;OTHER;OTHER
ldlc144.tiff;1;1;2480;3508;43462;639;2487;46;39;639;2487;685;2487;685;2526;639;2526;DE;AA;undefined;OTHER;OTHER
ldlc144.tiff;1;1;2480;3508;43463;694;2487;137;39;694;2487;831;2487;831;2526;694;2526;CALCUL;AAAAAA;undefined;OTHER;OTHER
ldlc144.tiff;1;1;2480;3508;43464;912;2487;111;39;912;2487;1023;2487;1023;2526;912;2526;TOTAL;AAAAA;undefined;OTHER;OTHER
ldlc144.tiff;1;1;2480;3508;43482;2208;2518;72;43;2208;2518;2280;2518;2280;2561;2208;2561;0,00;NSNN;undefined;OTHER;OTHER
ldlc144.tiff;1;1;2480;3508;43471;1425;2519;145;44;1425;2519;1570;2519;1570;2563;1425;2563;Montant;AAAAAAA;undefined;OTHER;OTHER
ldlc144.tiff;1;1;2480;3508;43472;1581;2519;72;44;1581;2519;1653;2519;1653;2563;1581;2563;port;AAAA;undefined;OTHER;OTHER
ldlc144.tiff;1;1;2480;3508;43483;2208;2561;114;43;2208;2561;2322;2561;2322;2604;2208;2604;1530.0;NNNNSN;TWTX;TOTAL_WITHOUT_TAX;TWTXS
ldlc144.tiff;1;1;2480;3508;43473;1425;2564;141;44;1425;2564;1566;2564;1566;2608;1425;2608;Amount;AAAAAA;undefined;OTHER;OTHER
ldlc144.tiff;1;1;2480;3508;43465;112;2568;18;38;112;2568;130;2568;130;2606;112;2606;4;N;undefined;OTHER;OTHER
ldlc144.tiff;1;1;2480;3508;43466;295;2568;37;38;295;2568;332;2568;332;2606;295;2606;20;NN;TXR;TAX_RATE;Tax Rate
ldlc144.tiff;1;1;2480;3508;43467;537;2568;101;38;537;2568;638;2568;638;2606;537;2606;1530.0;NNNNSN;TTX;TOTAL_TAX;Total Tax
ldlc144.tiff;1;1;2480;3508;43468;912;2568;83;38;912;2568;995;2568;995;2606;912;2606;306.0;NNNSN;undefined;OTHER;OTHER
ldlc144.tiff;1;1;2480;3508;43484;2208;2605;72;43;2208;2605;2280;2605;2280;2648;2208;2648;0,00;NSNN;undefined;OTHER;OTHER
ldlc144.tiff;1;1;2480;3508;43474;1425;2608;85;44;1425;2608;1510;2608;1510;2652;1425;2652;Dont;AAAA;undefined;OTHER;OTHER
ldlc144.tiff;1;1;2480;3508;43475;1520;2608;302;44;1520;2608;1822;2608;1822;2652;1520;2652;eco-participation;AAASAAAAAAAAAAAAA;undefined;OTHER;OTHER
ldlc144.tiff;1;1;2480;3508;43485;2208;2648;93;43;2208;2648;2301;2648;2301;2691;2208;2691;306.0;NNNSN;TTX;TOTAL_TAX;Total Tax
ldlc144.tiff;1;1;2480;3508;43476;1425;2653;160;44;1425;2653;1585;2653;1585;2697;1425;2697;VAT/TVA;AAASAAA;undefined;OTHER;OTHER
ldlc144.tiff;1;1;2480;3508;43486;2208;2691;114;43;2208;2691;2322;2691;2322;2734;2208;2734;1836.0;NNNNSN;TA;TOTAL_AMOUNT;Total with TAX
ldlc144.tiff;1;1;2480;3508;43477;1425;2698;89;44;1425;2698;1514;2698;1514;2742;1425;2742;Total;AAAAA;undefined;OTHER;OTHER
ldlc144.tiff;1;1;2480;3508;43478;1525;2698;141;44;1525;2698;1666;2698;1666;2742;1525;2742;Amount;AAAAAA;undefined;OTHER;OTHER
ldlc144.tiff;1;1;2480;3508;43487;2208;2735;114;43;2208;2735;2322;2735;2322;2778;2208;2778;1836.0;NNNNSN;TA;TOTAL_AMOUNT;Total with TAX
ldlc144.tiff;1;1;2480;3508;43479;1425;2742;95;44;1425;2742;1520;2742;1520;2786;1425;2786;Votre;AAAAA;undefined;OTHER;OTHER
ldlc144.tiff;1;1;2480;3508;43480;1531;2742;179;44;1531;2742;1710;2742;1710;2786;1531;2786;reglèment;AAAAAAAAA;undefined;OTHER;OTHER
ldlc144.tiff;1;1;2480;3508;43499;124;2750;70;44;124;2750;194;2750;194;2794;124;2794;Nos;AAA;undefined;OTHER;OTHER
ldlc144.tiff;1;1;2480;3508;43500;206;2750;145;44;206;2750;351;2750;351;2794;206;2794;factures;AAAAAAAA;undefined;OTHER;OTHER
ldlc144.tiff;1;1;2480;3508;43501;362;2750;79;44;362;2750;441;2750;441;2794;362;2794;sont;AAAA;undefined;OTHER;OTHER
ldlc144.tiff;1;1;2480;3508;43502;452;2750;148;44;452;2750;600;2750;600;2794;452;2794;libellées;AAAAAAAAA;undefined;OTHER;OTHER
ldlc144.tiff;1;1;2480;3508;43503;610;2750;43;44;610;2750;653;2750;653;2794;610;2794;en;AA;undefined;OTHER;OTHER
ldlc144.tiff;1;1;2480;3508;43504;664;2750;116;44;664;2750;780;2750;780;2794;664;2794;Euros.;AAAAAS;undefined;OTHER;OTHER
ldlc144.tiff;1;1;2480;3508;43505;124;2833;116;44;124;2833;240;2833;240;2877;124;2877;Aucun;AAAAA;undefined;OTHER;OTHER
ldlc144.tiff;1;1;2480;3508;43506;252;2833;175;44;252;2833;427;2833;427;2877;252;2877;escompte;AAAAAAAA;undefined;OTHER;OTHER
ldlc144.tiff;1;1;2480;3508;43507;437;2833;83;44;437;2833;520;2833;520;2877;437;2877;pour;AAAA;undefined;OTHER;OTHER
ldlc144.tiff;1;1;2480;3508;43508;531;2833;143;44;531;2833;674;2833;674;2877;531;2877;paiment;AAAAAAA;undefined;OTHER;OTHER
ldlc144.tiff;1;1;2480;3508;43509;685;2833;141;44;685;2833;826;2833;826;2877;685;2877;anticipé;AAAAAAAA;undefined;OTHER;OTHER
ldlc144.tiff;1;1;2480;3508;43510;837;2833;43;44;837;2833;880;2833;880;2877;837;2877;ne;AA;undefined;OTHER;OTHER
ldlc144.tiff;1;1;2480;3508;43511;891;2833;77;44;891;2833;968;2833;968;2877;891;2877;sera;AAAA;undefined;OTHER;OTHER
ldlc144.tiff;1;1;2480;3508;43512;979;2833;133;44;979;2833;1112;2833;1112;2877;979;2877;ccordé.;AAAAAAS;undefined;OTHER;OTHER
ldlc144.tiff;1;1;2480;3508;43488;1429;2841;75;44;1429;2841;1504;2841;1504;2885;1429;2885;NET;AAA;undefined;OTHER;OTHER
ldlc144.tiff;1;1;2480;3508;43489;1514;2841;27;44;1514;2841;1541;2841;1541;2885;1514;2885;A;A;undefined;OTHER;OTHER
ldlc144.tiff;1;1;2480;3508;43490;1552;2841;129;44;1552;2841;1681;2841;1681;2885;1552;2885;PAYER;AAAAA;undefined;OTHER;OTHER
ldlc144.tiff;1;1;2480;3508;43495;2125;2841;72;44;2125;2841;2197;2841;2197;2885;2125;2885;0,00;NSNN;undefined;OTHER;OTHER
ldlc144.tiff;1;1;2480;3508;43491;1429;2886;81;44;1429;2886;1510;2886;1510;2930;1429;2930;Date;AAAA;undefined;OTHER;OTHER
ldlc144.tiff;1;1;2480;3508;43492;1520;2886;97;44;1520;2886;1617;2886;1617;2930;1520;2930;limite;AAAAAA;undefined;OTHER;OTHER
ldlc144.tiff;1;1;2480;3508;43493;1629;2886;43;44;1629;2886;1672;2886;1672;2930;1629;2930;de;AA;undefined;OTHER;OTHER
ldlc144.tiff;1;1;2480;3508;43494;1683;2886;164;44;1683;2886;1847;2886;1847;2930;1683;2930;paiement;AAAAAAAA;undefined;OTHER;OTHER
ldlc144.tiff;1;1;2480;3508;43496;2125;2886;50;43;2125;2886;2175;2886;2175;2929;2125;2929;jun;AAA;IDATE;INVOICE_DATE;Invoice Date
ldlc144.tiff;1;1;2480;3508;43497;2185;2886;52;43;2185;2886;2237;2886;2237;2929;2185;2929;25,;NNS;IDATE;INVOICE_DATE;Invoice Date
ldlc144.tiff;1;1;2480;3508;43498;2248;2886;83;43;2248;2886;2331;2886;2331;2929;2248;2929;1990;NNNN;IDATE;INVOICE_DATE;Invoice Date
ldlc144.tiff;1;1;2480;3508;43513;116;2945;210;43;116;2945;326;2945;326;2988;116;2988;CONDITION;AAAAAAAAA;undefined;OTHER;OTHER
ldlc144.tiff;1;1;2480;3508;43514;337;2945;52;43;337;2945;389;2945;389;2988;337;2988;DE;AA;undefined;OTHER;OTHER
ldlc144.tiff;1;1;2480;3508;43515;400;2945;233;43;400;2945;633;2945;633;2988;400;2988;REGLEMENT;AAAAAAAAA;undefined;OTHER;OTHER
ldlc144.tiff;1;1;2480;3508;43518;800;2945;40;28;800;2945;840;2945;840;2973;800;2973;Les;AAA;undefined;OTHER;OTHER
ldlc144.tiff;1;1;2480;3508;43519;847;2945;112;28;847;2945;959;2945;959;2973;847;2973;conditions;AAAAAAAAAA;undefined;OTHER;OTHER
ldlc144.tiff;1;1;2480;3508;43520;966;2945;109;28;966;2945;1075;2945;1075;2973;966;2973;générales;AAAAAAAAA;undefined;OTHER;OTHER
ldlc144.tiff;1;1;2480;3508;43521;1083;2945;27;28;1083;2945;1110;2945;1110;2973;1083;2973;de;AA;undefined;OTHER;OTHER
ldlc144.tiff;1;1;2480;3508;43522;1118;2945;73;28;1118;2945;1191;2945;1191;2973;1118;2973;ventes;AAAAAA;undefined;OTHER;OTHER
ldlc144.tiff;1;1;2480;3508;43523;1198;2945;88;28;1198;2945;1286;2945;1286;2973;1198;2973;"(""CGV"")";SSAAASS;undefined;OTHER;OTHER
ldlc144.tiff;1;1;2480;3508;43524;1294;2945;125;28;1294;2945;1419;2945;1419;2973;1294;2973;appilcables;AAAAAAAAAAA;undefined;OTHER;OTHER
ldlc144.tiff;1;1;2480;3508;43525;1426;2945;13;28;1426;2945;1439;2945;1439;2973;1426;2973;a;A;undefined;OTHER;OTHER
ldlc144.tiff;1;1;2480;3508;43526;1447;2945;55;28;1447;2945;1502;2945;1502;2973;1447;2973;votre;AAAAA;undefined;OTHER;OTHER
ldlc144.tiff;1;1;2480;3508;43527;1509;2945;123;28;1509;2945;1632;2945;1632;2973;1509;2973;commande;AAAAAAAA;undefined;OTHER;OTHER
ldlc144.tiff;1;1;2480;3508;43528;1640;2945;113;28;1640;2945;1753;2945;1753;2973;1640;2973;acceptées;AAAAAAAAA;undefined;OTHER;OTHER
ldlc144.tiff;1;1;2480;3508;43529;1761;2945;40;28;1761;2945;1801;2945;1801;2973;1761;2973;lors;AAAA;undefined;OTHER;OTHER
ldlc144.tiff;1;1;2480;3508;43530;1808;2945;27;28;1808;2945;1835;2945;1835;2973;1808;2973;de;AA;undefined;OTHER;OTHER
ldlc144.tiff;1;1;2480;3508;43531;1843;2945;40;28;1843;2945;1883;2945;1883;2973;1843;2973;son;AAA;undefined;OTHER;OTHER
ldlc144.tiff;1;1;2480;3508;43532;1890;2945;166;28;1890;2945;2056;2945;2056;2973;1890;2973;enregistrement;AAAAAAAAAAAAAA;undefined;OTHER;OTHER
ldlc144.tiff;1;1;2480;3508;43533;2064;2945;47;28;2064;2945;2111;2945;2111;2973;2064;2973;sont;AAAA;undefined;OTHER;OTHER
ldlc144.tiff;1;1;2480;3508;43534;800;2974;116;28;800;2974;916;2974;916;3002;800;3002;également;AAAAAAAAA;undefined;OTHER;OTHER
ldlc144.tiff;1;1;2480;3508;43535;923;2974;125;28;923;2974;1048;2974;1048;3002;923;3002;disponibles;AAAAAAAAAAA;undefined;OTHER;OTHER
ldlc144.tiff;1;1;2480;3508;43536;1055;2974;34;28;1055;2974;1089;2974;1089;3002;1055;3002;sur;AAA;undefined;OTHER;OTHER
ldlc144.tiff;1;1;2480;3508;43537;1097;2974;56;28;1097;2974;1153;2974;1153;3002;1097;3002;notre;AAAAA;undefined;OTHER;OTHER
ldlc144.tiff;1;1;2480;3508;43538;1161;2974;45;28;1161;2974;1206;2974;1206;3002;1161;3002;site.;AAAAS;undefined;OTHER;OTHER
ldlc144.tiff;1;1;2480;3508;43516;116;2989;108;44;116;2989;224;2989;224;3033;116;3033;Credit;AAAAAA;undefined;OTHER;OTHER
ldlc144.tiff;1;1;2480;3508;43517;235;2989;79;44;235;2989;314;2989;314;3033;235;3033;card;AAAA;undefined;OTHER;OTHER
ldlc144.tiff;1;1;2480;3508;43539;800;3041;72;28;800;3041;872;3041;872;3069;800;3069;MILLE;AAAAA;SN;SUPPLIER_NAME;Seller/Company) name
ldlc144.tiff;1;1;2480;3508;43540;879;3041;31;28;879;3041;910;3041;910;3069;879;3069;ET;AA;SN;SUPPLIER_NAME;Seller/Company) name
ldlc144.tiff;1;1;2480;3508;43541;918;3041;36;28;918;3041;954;3041;954;3069;918;3069;UN;AA;SN;SUPPLIER_NAME;Seller/Company) name
ldlc144.tiff;1;1;2480;3508;43542;961;3041;88;28;961;3041;1049;3041;1049;3069;961;3069;LIVRES;AAAAAA;SN;SUPPLIER_NAME;Seller/Company) name
ldlc144.tiff;1;1;2480;3508;43543;1057;3041;0;28;1057;3041;1057;3041;1057;3069;1057;3069;;;undefined;OTHER;OTHER
ldlc144.tiff;1;1;2480;3508;43544;1063;3041;8;28;1063;3041;1071;3041;1071;3069;1063;3069;-;S;undefined;OTHER;OTHER
ldlc144.tiff;1;1;2480;3508;43545;1079;3041;33;28;1079;3041;1112;3041;1112;3069;1079;3069;SA;AA;undefined;OTHER;OTHER
ldlc144.tiff;1;1;2480;3508;43546;1119;3041;13;28;1119;3041;1132;3041;1132;3069;1119;3069;à;A;undefined;OTHER;OTHER
ldlc144.tiff;1;1;2480;3508;43547;1140;3041;102;28;1140;3041;1242;3041;1242;3069;1140;3069;directoire;AAAAAAAAAA;undefined;OTHER;OTHER
ldlc144.tiff;1;1;2480;3508;43548;1250;3041;20;28;1250;3041;1270;3041;1270;3069;1250;3069;et;AA;undefined;OTHER;OTHER
ldlc144.tiff;1;1;2480;3508;43549;1277;3041;77;28;1277;3041;1354;3041;1354;3069;1277;3069;conseil;AAAAAAA;undefined;OTHER;OTHER
ldlc144.tiff;1;1;2480;3508;43550;1362;3041;27;28;1362;3041;1389;3041;1389;3069;1362;3069;de;AA;undefined;OTHER;OTHER
ldlc144.tiff;1;1;2480;3508;43551;1397;3041;131;28;1397;3041;1528;3041;1528;3069;1397;3069;surveillance;AAAAAAAAAAAA;undefined;OTHER;OTHER
ldlc144.tiff;1;1;2480;3508;43552;1536;3041;27;28;1536;3041;1563;3041;1563;3069;1536;3069;au;AA;undefined;OTHER;OTHER
ldlc144.tiff;1;1;2480;3508;43553;1571;3041;72;28;1571;3041;1643;3041;1643;3069;1571;3069;capital;AAAAAAA;undefined;OTHER;OTHER
ldlc144.tiff;1;1;2480;3508;43554;1650;3041;27;28;1650;3041;1677;3041;1677;3069;1650;3069;de;AA;undefined;OTHER;OTHER
ldlc144.tiff;1;1;2480;3508;43555;1685;3041;97;28;1685;3041;1782;3041;1782;3069;1685;3069;1862677;NNNNNNN;undefined;OTHER;OTHER
ldlc144.tiff;1;1;2480;3508;43556;1789;3041;38;28;1789;3041;1827;3041;1827;3069;1789;3069;Eur;AAA;undefined;OTHER;OTHER
ldlc144.tiff;1;1;2480;3508;43557;1835;3041;8;28;1835;3041;1843;3041;1843;3069;1835;3069;-;S;undefined;OTHER;OTHER
ldlc144.tiff;1;1;2480;3508;43558;1850;3041;125;28;1850;3041;1975;3041;1975;3069;1850;3069;667057091;NNNNNNNNN;SCID;SUPPLIER_ID;Seller Identifier Number (Siren)
ldlc144.tiff;1;1;2480;3508;43559;800;3070;50;28;800;3070;850;3070;850;3098;800;3098;APE;AAA;undefined;OTHER;OTHER
ldlc144.tiff;1;1;2480;3508;43560;856;3070;0;28;856;3070;856;3070;856;3098;856;3098;;;undefined;OTHER;OTHER
ldlc144.tiff;1;1;2480;3508;43561;863;3070;8;28;863;3070;871;3070;871;3098;863;3098;-;S;undefined;OTHER;OTHER
ldlc144.tiff;1;1;2480;3508;43562;879;3070;48;28;879;3070;927;3070;927;3098;879;3098;VAT;AAA;undefined;OTHER;OTHER
ldlc144.tiff;1;1;2480;3508;43563;934;3070;186;28;934;3070;1120;3070;1120;3098;934;3098;FR78667057091;AANNNNNNNNNNN;SVAT;SUPPLIER_VAT;Seller Vat Number/TVA
ldlc144.tiff;1;1;2480;3508;43564;800;3098;51;28;800;3098;851;3098;851;3126;800;3126;Siret;AAAAA;undefined;OTHER;OTHER
ldlc144.tiff;1;1;2480;3508;43565;858;3098;6;28;858;3098;864;3098;864;3126;858;3126;:;S;undefined;OTHER;OTHER
ldlc144.tiff;1;1;2480;3508;43566;872;3098;194;28;872;3098;1066;3098;1066;3126;872;3126;66705709143357;NNNNNNNNNNNNNN;undefined;OTHER;OTHER
ldlc144.tiff;1;1;2480;3508;43567;991;3274;31;28;991;3274;1022;3274;1022;3302;991;3302;Ne;AA;undefined;OTHER;OTHER
ldlc144.tiff;1;1;2480;3508;43568;1030;3274;40;28;1030;3274;1070;3274;1070;3302;1030;3302;pas;AAA;undefined;OTHER;OTHER
ldlc144.tiff;1;1;2480;3508;43569;1077;3274;48;28;1077;3274;1125;3274;1125;3302;1077;3302;jeter;AAAAA;undefined;OTHER;OTHER
ldlc144.tiff;1;1;2480;3508;43570;1133;3274;34;28;1133;3274;1167;3274;1167;3302;1133;3302;sur;AAA;undefined;OTHER;OTHER
ldlc144.tiff;1;1;2480;3508;43571;1175;3274;19;28;1175;3274;1194;3274;1194;3302;1175;3302;la;AA;undefined;OTHER;OTHER
ldlc144.tiff;1;1;2480;3508;43572;1201;3274;45;28;1201;3274;1246;3274;1246;3302;1201;3302;voie;AAAA;undefined;OTHER;OTHER
ldlc144.tiff;1;1;2480;3508;43573;1254;3274;94;28;1254;3274;1348;3274;1348;3302;1254;3302;publique;AAAAAAAA;undefined;OTHER;OTHER
