src;num_pages;page_id;page_width;page_height;id;col;row;width;height;x1;y1;x2;y2;x3;y3;x4;y4;contents;contents_masked;correctclass;tag;description
invoice-2517.tiff;1;1;2480;3508;309855;1624;62;518;175;1624;62;2142;62;2142;237;1624;237;common/logo;AAAAAASAAAA;img;IMAGE;Image
invoice-2517.tiff;1;1;2480;3508;309833;124;237;50;43;124;237;174;237;174;280;124;280;LE;AA;SN;SUPPLIER_NAME;Seller/Company) name
invoice-2517.tiff;1;1;2480;3508;309834;200;237;100;43;200;237;300;237;300;280;200;280;PATA;AAAA;SN;SUPPLIER_NAME;Seller/Company) name
invoice-2517.tiff;1;1;2480;3508;309835;325;237;124;43;325;237;449;237;449;280;325;280;NEGRA;AAAAA;SN;SUPPLIER_NAME;Seller/Company) name
invoice-2517.tiff;1;1;2480;3508;309836;124;281;249;43;124;281;373;281;373;324;124;324;MONTIMARAN;AAAAAAAAAA;SA;SUPPLIER_ADDRESS;Seller Address
invoice-2517.tiff;1;1;2480;3508;309837;383;281;25;43;383;281;408;281;408;324;383;324;-;S;SA;SUPPLIER_ADDRESS;Seller Address
invoice-2517.tiff;1;1;2480;3508;309838;433;281;124;43;433;281;557;281;557;324;433;324;34500;NNNNN;SA;SUPPLIER_ADDRESS;Seller Address
invoice-2517.tiff;1;1;2480;3508;309839;591;281;175;43;591;281;766;281;766;324;591;324;BEZIERS;AAAAAAA;SA;SUPPLIER_ADDRESS;Seller Address
invoice-2517.tiff;1;1;2480;3508;309840;124;325;124;43;124;325;248;325;248;368;124;368;Siren;AAAAA;undefined;OTHER;OTHER
invoice-2517.tiff;1;1;2480;3508;309841;266;325;75;43;266;325;341;325;341;368;266;368;420;NNN;SCID;SUPPLIER_ID;Seller Identifier Number (Siren)
invoice-2517.tiff;1;1;2480;3508;309842;366;325;75;43;366;325;441;325;441;368;366;368;518;NNN;SCID;SUPPLIER_ID;Seller Identifier Number (Siren)
invoice-2517.tiff;1;1;2480;3508;309843;466;325;75;43;466;325;541;325;541;368;466;368;726;NNN;SCID;SUPPLIER_ID;Seller Identifier Number (Siren)
invoice-2517.tiff;1;1;2480;3508;309844;566;325;175;43;566;325;741;325;741;368;566;368;VAT/TIN;AAASAAA;undefined;OTHER;OTHER
invoice-2517.tiff;1;1;2480;3508;309845;766;325;150;43;766;325;916;325;916;368;766;368;Number;AAAAAA;undefined;OTHER;OTHER
invoice-2517.tiff;1;1;2480;3508;309846;933;325;50;43;933;325;983;325;983;368;933;368;FR;AA;SVAT;SUPPLIER_VAT;Seller Vat Number/TVA
invoice-2517.tiff;1;1;2480;3508;309847;1008;325;50;43;1008;325;1058;325;1058;368;1008;368;89;NN;SVAT;SUPPLIER_VAT;Seller Vat Number/TVA
invoice-2517.tiff;1;1;2480;3508;309848;1083;325;75;43;1083;325;1158;325;1158;368;1083;368;420;NNN;SVAT;SUPPLIER_VAT;Seller Vat Number/TVA
invoice-2517.tiff;1;1;2480;3508;309849;1183;325;75;43;1183;325;1258;325;1258;368;1183;368;518;NNN;SVAT;SUPPLIER_VAT;Seller Vat Number/TVA
invoice-2517.tiff;1;1;2480;3508;309850;1283;325;75;43;1283;325;1358;325;1358;368;1283;368;726;NNN;SVAT;SUPPLIER_VAT;Seller Vat Number/TVA
invoice-2517.tiff;1;1;2480;3508;309851;124;369;124;43;124;369;248;369;248;412;124;412;Phone;AAAAA;undefined;OTHER;OTHER
invoice-2517.tiff;1;1;2480;3508;309852;275;369;350;43;275;369;625;369;625;412;275;412;02-12-12-05-62;NNSNNSNNSNNSNN;SCN;SUPPLIER_CONTACT_NUMBER;Seller Contact Number
invoice-2517.tiff;1;1;2480;3508;309853;666;369;75;43;666;369;741;369;741;412;666;412;Fax;AAA;undefined;OTHER;OTHER
invoice-2517.tiff;1;1;2480;3508;309854;766;369;350;43;766;369;1116;369;1116;412;766;412;02-12-12-30-95;NNSNNSNNSNNSNN;SFAX;SUPPLIER_FAX_NUMBER;Seller Fax Number
invoice-2517.tiff;1;1;2480;3508;309856;124;589;119;52;124;589;243;589;243;641;124;641;Ship;AAAA;undefined;OTHER;OTHER
invoice-2517.tiff;1;1;2480;3508;309857;275;589;59;52;275;589;334;589;334;641;275;641;To;AA;undefined;OTHER;OTHER
invoice-2517.tiff;1;1;2480;3508;309858;124;642;100;43;124;642;224;642;224;685;124;685;Mack;AAAA;SHN;SHIPPING_NAME;Shipping Name
invoice-2517.tiff;1;1;2480;3508;309859;249;642;150;43;249;642;399;642;399;685;249;685;Spinka;AAAAAA;SHN;SHIPPING_NAME;Shipping Name
invoice-2517.tiff;1;1;2480;3508;309867;1541;642;100;43;1541;642;1641;642;1641;685;1541;685;Mack;AAAA;BN;BILLING_NAME;Billing Name
invoice-2517.tiff;1;1;2480;3508;309868;1666;642;150;43;1666;642;1816;642;1816;685;1666;685;Spinka;AAAAAA;BN;BILLING_NAME;Billing Name
invoice-2517.tiff;1;1;2480;3508;309860;124;686;50;43;124;686;174;686;174;729;124;729;7,;NS;SHA;SHIPPING_ADDRESS;Shipping Address
invoice-2517.tiff;1;1;2480;3508;309861;200;686;75;43;200;686;275;686;275;729;200;729;rue;AAA;SHA;SHIPPING_ADDRESS;Shipping Address
invoice-2517.tiff;1;1;2480;3508;309862;300;686;50;43;300;686;350;686;350;729;300;729;de;AA;SHA;SHIPPING_ADDRESS;Shipping Address
invoice-2517.tiff;1;1;2480;3508;309863;375;686;150;43;375;686;525;686;525;729;375;729;nicole;AAAAAA;SHA;SHIPPING_ADDRESS;Shipping Address
invoice-2517.tiff;1;1;2480;3508;309869;1541;686;50;43;1541;686;1591;686;1591;729;1541;729;7,;NS;BA;BILLING_ADDRESS;Billing Address
invoice-2517.tiff;1;1;2480;3508;309870;1616;686;75;43;1616;686;1691;686;1691;729;1616;729;rue;AAA;BA;BILLING_ADDRESS;Billing Address
invoice-2517.tiff;1;1;2480;3508;309871;1716;686;50;43;1716;686;1766;686;1766;729;1716;729;de;AA;BA;BILLING_ADDRESS;Billing Address
invoice-2517.tiff;1;1;2480;3508;309872;1791;686;150;43;1791;686;1941;686;1941;729;1791;729;nicole;AAAAAA;BA;BILLING_ADDRESS;Billing Address
invoice-2517.tiff;1;1;2480;3508;309864;124;730;124;43;124;730;248;730;248;773;124;773;33230;NNNNN;SHA;SHIPPING_ADDRESS;Shipping Address
invoice-2517.tiff;1;1;2480;3508;309865;291;730;175;43;291;730;466;730;466;773;291;773;Guîtres;AAAAAAA;SHA;SHIPPING_ADDRESS;Shipping Address
invoice-2517.tiff;1;1;2480;3508;309873;1541;730;124;43;1541;730;1665;730;1665;773;1541;773;33230;NNNNN;BA;BILLING_ADDRESS;Billing Address
invoice-2517.tiff;1;1;2480;3508;309874;1708;730;175;43;1708;730;1883;730;1883;773;1708;773;Guîtres;AAAAAAA;BA;BILLING_ADDRESS;Billing Address
invoice-2517.tiff;1;1;2480;3508;309866;124;774;150;43;124;774;274;774;274;817;124;817;France;AAAAAA;SHA;SHIPPING_ADDRESS;Shipping Address
invoice-2517.tiff;1;1;2480;3508;309875;1541;774;150;43;1541;774;1691;774;1691;817;1541;817;France;AAAAAA;BA;BILLING_ADDRESS;Billing Address
invoice-2517.tiff;1;1;2480;3508;309876;1541;1015;192;48;1541;1015;1733;1015;1733;1063;1541;1063;Invoice;AAAAAAA;undefined;OTHER;OTHER
invoice-2517.tiff;1;1;2480;3508;309877;1761;1015;82;48;1761;1015;1843;1015;1843;1063;1761;1063;No.;AAS;undefined;OTHER;OTHER
invoice-2517.tiff;1;1;2480;3508;309878;2166;1015;175;43;2166;1015;2341;1015;2341;1058;2166;1058;0010392;NNNNNNN;IN;INVOICE_NUMBER;Invoice Number
invoice-2517.tiff;1;1;2480;3508;309879;1541;1084;192;48;1541;1084;1733;1084;1733;1132;1541;1132;Invoice;AAAAAAA;undefined;OTHER;OTHER
invoice-2517.tiff;1;1;2480;3508;309880;1761;1084;109;48;1761;1084;1870;1084;1870;1132;1761;1132;Date;AAAA;undefined;OTHER;OTHER
invoice-2517.tiff;1;1;2480;3508;309881;2166;1084;50;43;2166;1084;2216;1084;2216;1127;2166;1127;10;NN;IDATE;INVOICE_DATE;Invoice Date
invoice-2517.tiff;1;1;2480;3508;309882;2241;1084;100;43;2241;1084;2341;1084;2341;1127;2241;1127;oct,;AAAS;IDATE;INVOICE_DATE;Invoice Date
invoice-2517.tiff;1;1;2480;3508;309883;2366;1084;100;43;2366;1084;2466;1084;2466;1127;2366;1127;1994;NNNN;IDATE;INVOICE_DATE;Invoice Date
invoice-2517.tiff;1;1;2480;3508;309884;1541;1153;137;48;1541;1153;1678;1153;1678;1201;1541;1201;Order;AAAAA;undefined;OTHER;OTHER
invoice-2517.tiff;1;1;2480;3508;309885;1706;1153;82;48;1706;1153;1788;1153;1788;1201;1706;1201;No.;AAS;undefined;OTHER;OTHER
invoice-2517.tiff;1;1;2480;3508;309886;2166;1153;124;43;2166;1153;2290;1153;2290;1196;2166;1196;99867;NNNNN;ONUM;ORDER_NUMBER;Order Number
invoice-2517.tiff;1;1;2480;3508;309887;139;1660;137;48;139;1660;276;1660;276;1708;139;1708;S.No.;ASAAS;undefined;OTHER;OTHER
invoice-2517.tiff;1;1;2480;3508;309888;327;1660;219;48;327;1660;546;1660;546;1708;327;1708;Quantity;AAAAAAAA;undefined;OTHER;OTHER
invoice-2517.tiff;1;1;2480;3508;309889;717;1660;192;48;717;1660;909;1660;909;1708;717;1708;Product;AAAAAAA;undefined;OTHER;OTHER
invoice-2517.tiff;1;1;2480;3508;309890;937;1660;302;48;937;1660;1239;1660;1239;1708;937;1708;Description;AAAAAAAAAAA;undefined;OTHER;OTHER
invoice-2517.tiff;1;1;2480;3508;309891;1383;1660;109;48;1383;1660;1492;1660;1492;1708;1383;1708;Unit;AAAA;undefined;OTHER;OTHER
invoice-2517.tiff;1;1;2480;3508;309892;1520;1660;137;48;1520;1660;1657;1660;1657;1708;1520;1708;Price;AAAAA;undefined;OTHER;OTHER
invoice-2517.tiff;1;1;2480;3508;309893;1702;1660;82;48;1702;1660;1784;1660;1784;1708;1702;1708;TVA;AAA;undefined;OTHER;OTHER
invoice-2517.tiff;1;1;2480;3508;309894;1812;1660;109;48;1812;1660;1921;1660;1921;1708;1812;1708;Rate;AAAA;undefined;OTHER;OTHER
invoice-2517.tiff;1;1;2480;3508;309895;2035;1660;137;48;2035;1660;2172;1660;2172;1708;2035;1708;Total;AAAAA;undefined;OTHER;OTHER
invoice-2517.tiff;1;1;2480;3508;309896;195;1729;25;43;195;1729;220;1729;220;1772;195;1772;1;N;undefined;OTHER;OTHER
invoice-2517.tiff;1;1;2480;3508;309897;424;1729;25;43;424;1729;449;1729;449;1772;424;1772;3;N;undefined;OTHER;OTHER
invoice-2517.tiff;1;1;2480;3508;309898;583;1729;50;43;583;1729;633;1729;633;1772;583;1772;PC;AA;undefined;OTHER;OTHER
invoice-2517.tiff;1;1;2480;3508;309899;658;1729;175;43;658;1729;833;1729;833;1772;658;1772;Hybride;AAAAAAA;undefined;OTHER;OTHER
invoice-2517.tiff;1;1;2480;3508;309900;858;1729;224;43;858;1729;1082;1729;1082;1772;858;1772;Microsoft;AAAAAAAAA;undefined;OTHER;OTHER
invoice-2517.tiff;1;1;2480;3508;309901;1108;1729;175;43;1108;1729;1283;1729;1283;1772;1108;1772;Surface;AAAAAAA;undefined;OTHER;OTHER
invoice-2517.tiff;1;1;2480;3508;309907;1383;1729;175;43;1383;1729;1558;1729;1558;1772;1383;1772;1874,17;NNNNSNN;undefined;OTHER;OTHER
invoice-2517.tiff;1;1;2480;3508;309908;1583;1729;75;43;1583;1729;1658;1729;1658;1772;1583;1772;EUR;AAA;undefined;OTHER;OTHER
invoice-2517.tiff;1;1;2480;3508;309909;1749;1729;124;43;1749;1729;1873;1729;1873;1772;1749;1772;20.0%;NNSNS;undefined;OTHER;OTHER
invoice-2517.tiff;1;1;2480;3508;309910;1966;1729;175;43;1966;1729;2141;1729;2141;1772;1966;1772;5622,50;NNNNSNN;undefined;OTHER;OTHER
invoice-2517.tiff;1;1;2480;3508;309911;2166;1729;75;43;2166;1729;2241;1729;2241;1772;2166;1772;EUR;AAA;undefined;OTHER;OTHER
invoice-2517.tiff;1;1;2480;3508;309902;583;1773;100;43;583;1773;683;1773;683;1816;583;1816;Book;AAAA;undefined;OTHER;OTHER
invoice-2517.tiff;1;1;2480;3508;309903;708;1773;25;43;708;1773;733;1773;733;1816;708;1816;2;N;undefined;OTHER;OTHER
invoice-2517.tiff;1;1;2480;3508;309904;758;1773;50;43;758;1773;808;1773;808;1816;758;1816;i7;AN;undefined;OTHER;OTHER
invoice-2517.tiff;1;1;2480;3508;309905;833;1773;75;43;833;1773;908;1773;908;1816;833;1816;8Go;NAA;undefined;OTHER;OTHER
invoice-2517.tiff;1;1;2480;3508;309906;933;1773;124;43;933;1773;1057;1773;1057;1816;933;1816;256Go;NNNAA;undefined;OTHER;OTHER
invoice-2517.tiff;1;1;2480;3508;309912;195;1859;25;43;195;1859;220;1859;220;1902;195;1902;2;N;undefined;OTHER;OTHER
invoice-2517.tiff;1;1;2480;3508;309913;424;1859;25;43;424;1859;449;1859;449;1902;424;1902;3;N;undefined;OTHER;OTHER
invoice-2517.tiff;1;1;2480;3508;309914;583;1859;224;43;583;1859;807;1859;807;1902;583;1902;Nettoyant;AAAAAAAAA;undefined;OTHER;OTHER
invoice-2517.tiff;1;1;2480;3508;309915;833;1859;124;43;833;1859;957;1859;957;1902;833;1902;Polti;AAAAA;undefined;OTHER;OTHER
invoice-2517.tiff;1;1;2480;3508;309916;983;1859;325;43;983;1859;1308;1859;1308;1902;983;1902;HP007ANTIBACT;AANNNAAAAAAAA;undefined;OTHER;OTHER
invoice-2517.tiff;1;1;2480;3508;309920;1420;1859;100;43;1420;1859;1520;1859;1520;1902;1420;1902;8,32;NSNN;undefined;OTHER;OTHER
invoice-2517.tiff;1;1;2480;3508;309921;1545;1859;75;43;1545;1859;1620;1859;1620;1902;1545;1902;EUR;AAA;undefined;OTHER;OTHER
invoice-2517.tiff;1;1;2480;3508;309922;1749;1859;124;43;1749;1859;1873;1859;1873;1902;1749;1902;20.0%;NNSNS;undefined;OTHER;OTHER
invoice-2517.tiff;1;1;2480;3508;309923;1991;1859;124;43;1991;1859;2115;1859;2115;1902;1991;1902;24,97;NNSNN;undefined;OTHER;OTHER
invoice-2517.tiff;1;1;2480;3508;309924;2141;1859;75;43;2141;1859;2216;1859;2216;1902;2141;1902;EUR;AAA;undefined;OTHER;OTHER
invoice-2517.tiff;1;1;2480;3508;309917;583;1902;124;43;583;1902;707;1902;707;1945;583;1945;SPRAY;AAAAA;undefined;OTHER;OTHER
invoice-2517.tiff;1;1;2480;3508;309918;733;1902;75;43;733;1902;808;1902;808;1945;733;1945;500;NNN;undefined;OTHER;OTHER
invoice-2517.tiff;1;1;2480;3508;309919;833;1902;50;43;833;1902;883;1902;883;1945;833;1945;ml;AA;undefined;OTHER;OTHER
invoice-2517.tiff;1;1;2480;3508;309925;195;1988;25;43;195;1988;220;1988;220;2031;195;2031;3;N;undefined;OTHER;OTHER
invoice-2517.tiff;1;1;2480;3508;309926;424;1988;25;43;424;1988;449;1988;449;2031;424;2031;3;N;undefined;OTHER;OTHER
invoice-2517.tiff;1;1;2480;3508;309927;583;1988;275;43;583;1988;858;1988;858;2031;583;2031;Thermomètre;AAAAAAAAAAA;undefined;OTHER;OTHER
invoice-2517.tiff;1;1;2480;3508;309928;883;1988;200;43;883;1988;1083;1988;1083;2031;883;2031;Babymoov;AAAAAAAA;undefined;OTHER;OTHER
invoice-2517.tiff;1;1;2480;3508;309931;1408;1988;124;43;1408;1988;1532;1988;1532;2031;1408;2031;20,83;NNSNN;undefined;OTHER;OTHER
invoice-2517.tiff;1;1;2480;3508;309932;1558;1988;75;43;1558;1988;1633;1988;1633;2031;1558;2031;EUR;AAA;undefined;OTHER;OTHER
invoice-2517.tiff;1;1;2480;3508;309933;1749;1988;124;43;1749;1988;1873;1988;1873;2031;1749;2031;20.0%;NNSNS;undefined;OTHER;OTHER
invoice-2517.tiff;1;1;2480;3508;309934;1991;1988;124;43;1991;1988;2115;1988;2115;2031;1991;2031;62,48;NNSNN;undefined;OTHER;OTHER
invoice-2517.tiff;1;1;2480;3508;309935;2141;1988;75;43;2141;1988;2216;1988;2216;2031;2141;2031;EUR;AAA;undefined;OTHER;OTHER
invoice-2517.tiff;1;1;2480;3508;309929;583;2032;550;43;583;2032;1133;2032;1133;2075;583;2075;Thermomètre-hygromètre;AAAAAAAAAAASAAAAAAAAAA;undefined;OTHER;OTHER
invoice-2517.tiff;1;1;2480;3508;309930;1158;2032;175;43;1158;2032;1333;2032;1333;2075;1158;2075;A037403;ANNNNNN;undefined;OTHER;OTHER
invoice-2517.tiff;1;1;2480;3508;309936;1767;2159;219;48;1767;2159;1986;2159;1986;2207;1767;2207;Discount;AAAAAAAA;undefined;OTHER;OTHER
invoice-2517.tiff;1;1;2480;3508;309937;2008;2159;100;43;2008;2159;2108;2159;2108;2202;2008;2202;0,00;NSNN;undefined;OTHER;OTHER
invoice-2517.tiff;1;1;2480;3508;309938;2133;2159;75;43;2133;2159;2208;2159;2208;2202;2133;2202;EUR;AAA;undefined;OTHER;OTHER
invoice-2517.tiff;1;1;2480;3508;309939;1754;2207;137;48;1754;2207;1891;2207;1891;2255;1754;2255;Total;AAAAA;undefined;OTHER;OTHER
invoice-2517.tiff;1;1;2480;3508;309940;1933;2207;175;43;1933;2207;2108;2207;2108;2250;1933;2250;5709,95;NNNNSNN;TWTX;TOTAL_WITHOUT_TAX;TWTXS
invoice-2517.tiff;1;1;2480;3508;309941;2133;2207;75;43;2133;2207;2208;2207;2208;2250;2133;2250;EUR;AAA;TWTX;TOTAL_WITHOUT_TAX;TWTXS
invoice-2517.tiff;1;1;2480;3508;309942;1616;2256;82;48;1616;2256;1698;2256;1698;2304;1616;2304;Tax;AAA;undefined;OTHER;OTHER
invoice-2517.tiff;1;1;2480;3508;309943;1726;2256;164;48;1726;2256;1890;2256;1890;2304;1726;2304;Amount;AAAAAA;undefined;OTHER;OTHER
invoice-2517.tiff;1;1;2480;3508;309944;1933;2256;175;43;1933;2256;2108;2256;2108;2299;1933;2299;1141,99;NNNNSNN;TTX;TOTAL_TAX;Total Tax
invoice-2517.tiff;1;1;2480;3508;309945;2133;2256;75;43;2133;2256;2208;2256;2208;2299;2133;2299;EUR;AAA;TTX;TOTAL_TAX;Total Tax
invoice-2517.tiff;1;1;2480;3508;309946;1534;2304;164;48;1534;2304;1698;2304;1698;2352;1534;2352;Amount;AAAAAA;undefined;OTHER;OTHER
invoice-2517.tiff;1;1;2480;3508;309947;1726;2304;54;48;1726;2304;1780;2304;1780;2352;1726;2352;to;AA;undefined;OTHER;OTHER
invoice-2517.tiff;1;1;2480;3508;309948;1809;2304;82;48;1809;2304;1891;2304;1891;2352;1809;2352;pay;AAA;undefined;OTHER;OTHER
invoice-2517.tiff;1;1;2480;3508;309949;1933;2304;175;43;1933;2304;2108;2304;2108;2347;1933;2347;6851,94;NNNNSNN;TA;TOTAL_AMOUNT;Total with TAX
invoice-2517.tiff;1;1;2480;3508;309950;2133;2304;75;43;2133;2304;2208;2304;2208;2347;2133;2347;EUR;AAA;TA;TOTAL_AMOUNT;Total with TAX
invoice-2517.tiff;1;1;2480;3508;309951;124;3175;50;43;124;3175;174;3175;174;3218;124;3218;LE;AA;SN;SUPPLIER_NAME;Seller/Company) name
invoice-2517.tiff;1;1;2480;3508;309952;200;3175;100;43;200;3175;300;3175;300;3218;200;3218;PATA;AAAA;SN;SUPPLIER_NAME;Seller/Company) name
invoice-2517.tiff;1;1;2480;3508;309953;325;3175;124;43;325;3175;449;3175;449;3218;325;3218;NEGRA;AAAAA;SN;SUPPLIER_NAME;Seller/Company) name
invoice-2517.tiff;1;1;2480;3508;309954;124;3218;249;43;124;3218;373;3218;373;3261;124;3261;MONTIMARAN;AAAAAAAAAA;SA;SUPPLIER_ADDRESS;Seller Address
invoice-2517.tiff;1;1;2480;3508;309955;383;3218;25;43;383;3218;408;3218;408;3261;383;3261;-;S;SA;SUPPLIER_ADDRESS;Seller Address
invoice-2517.tiff;1;1;2480;3508;309956;433;3218;124;43;433;3218;557;3218;557;3261;433;3261;34500;NNNNN;SA;SUPPLIER_ADDRESS;Seller Address
invoice-2517.tiff;1;1;2480;3508;309957;591;3218;175;43;591;3218;766;3218;766;3261;591;3261;BEZIERS;AAAAAAA;SA;SUPPLIER_ADDRESS;Seller Address
